Habe	VHPI1S
mir	PP1SD
gestern	RP
bei	APPD
Amazon	NP
gleich	RP
noch	RP
ein_paar	DZ
halbhohe	JPPA
original	JP
MBT's	NPP
gekauft	VLPP
,	,
denn	CS
im	APPD
Winter	NCMSD
bei	APPD
Matsch	NCMSD
mit	APPD
weissen	JPPD
Sketchers	NPD
geht	VLPI3S
ja	RP
so	RP
gar	RP
nicht	QNEG
.	.

Ist	VSPI3S
schon	RP
lächerlich	JP
,	,
dass	CS
ich	PP1SN
mich	PP1SA
mit	APPD
Alignments	NPD
usw.	QG
auseinander	RP
setzen	VLINF
muss	VMPI1S
,	,
wovon	RD
ich	PP1SN
noch	RP
nie	RP
was	PSSA
gehört	VLPP
hab	VHPI1S
.	.

Kürzlich	RP
bin	VSPI1S
ich	PP1SN
von	APPD
einem	ATIND
ca.	RP
3	ZC
Jahre	NCNPA
alten	JPND
Notebook	NCNSD
mit	APPD
Windows	NP
Vista	NP
auf	APPA
ein	ATINA
neues	JPNA
mit	APPD
Windows	NP
7	ZC
umgestiegen	VLPP
in	APPD
der	ATDFD
Hoffnung	NCFSD
die	ATDFA
Zeit	NCFSA
dadurch	RD
dramatisch	RP
zu	QZU
verkürzen	VLINF
.	.
