AOL	Lao	Ola
AOL's	Lao's	Ola's
Abby	baby
Abby's	baby's
Abel	Bela	Elba	able	bale
Abel's	Bela's	Elba's	bale's
Abner	Arneb
Abner's	Arneb's
Ac	Ca
Ac's	Ca's
Acton	canto
Acton's	canto's
Acts	acts	cast	cats	scat
Adan	Dana
Adan's	Dana's
Addams	Saddam
Addie	aided
Adeline	aliened
Aden	Dane	Dean	Dena	Edna	dean
Aden's	Dane's	Dean's	Dena's	Edna's	dean's
Adler	alder
Adler's	alder's
Advent	advent
Advent's	advent's
Advents	advents
Advil	Vidal	valid
Advil's	Vidal's
Afghan	afghan
Afghan's	afghan's
Afghans	afghans
Afro	fora
Ag	Ga
Ag's	Ga's
Agni	Gina	gain
Agni's	Gina's
Agra	agar	raga
Agra's	agar's	raga's
Aileen	Elaine
Aileen's	Elaine's
Akron	Koran
Akron's	Koran's
Al	La	la
Al's	La's	la's
Alan	Lana	anal
Alan's	Lana's
Alar	Aral	Lara
Alaric	racial
Alba	Baal
Alba's	Baal's
Alberio	Albireo
Alberio's	Albireo's
Alberto	Latrobe
Alberto's	Latrobe's
Albion	albino
Albion's	albino's
Alcestis	elastics	scaliest
Alcmena	manacle
Alcmena's	manacle's
Alcuin	Lucian
Alcuin's	Lucian's
Alden	Nelda	laden
Alden's	Nelda's
Aldo	load
Aldo's	load's
Alec	lace
Alec's	lace's
Alex	axle
Alex's	axle's
Alfred	flared
Algenib	Belgian	Bengali
Algenib's	Belgian's	Bengali's
Alger	Elgar	glare	lager	large	regal
Alger's	Elgar's	lager's
Algeria	regalia
Algeria's	regalia's
Algol	Gallo
Algol's	Gallo's
Ali	Ila	ail
Ali's	Ila's
Alice	Celia
Alice's	Celia's
Aline	alien
Aline's	alien's
Alisa	alias
Alissa	assail
Allie	Leila	Lelia
Allie's	Leila's	Lelia's
Alma	lama
Alma's	lama's
Almighty	almighty
Alpine	Nepali	alpine
Alpo	Opal	opal
Alpo's	Opal's	opal's
Alps	laps	pals	slap
Alsop	opals
Alston	Salton	talons
Alston's	Salton's
Altair	lariat
Altair's	lariat's
Alton	talon	tonal
Alton's	talon's
Alva	lava
Alva's	lava's
Alvin	anvil
Alvin's	anvil's
Alyce	Lacey
Alyce's	Lacey's
Am	am	ma
Am's	ma's
Amaru	Maura
Amaru's	Maura's
Amazon	amazon
Amazon's	amazon's
Amazons	amazons
Amber	amber
Amber's	amber's
American	Cinerama
Amherst	hamster
Amherst's	hamster's
Ampere	ampere
Ampere's	ampere's
Amundsen	mundanes
Amy	May	may	yam
Amy's	May's	yam's
Anchorage	anchorage
Anchorage's	anchorage's
Andean	Deanna
Andersen	ensnared
Andes	Danes	Snead	deans	saned	sedan
Andre	Arden	Daren	Nader
Andre's	Arden's	Daren's	Nader's
Andrei	rained
Andres	sander	snared
Andrew	wander	warden	warned
Andrew's	warden's
Andrews	wanders	wardens
Angel	Galen	angel	angle	glean
Angel's	Galen's	angel's	angle's
Angela	galena
Angela's	galena's
Anglo	Golan	Logan	along
Anglo's	Golan's	Logan's
Anglos	slogan
Angola	analog
Angola's	analog's
Angora	angora
Angora's	angora's
Angoras	angoras
Anita	Tania
Anita's	Tania's
Ann	Nan
Ann's	Nan's
Annam	manna
Annam's	manna's
Annette	Nanette
Annette's	Nanette's
Annie	inane
Annmarie	Armenian	Marianne
Annmarie's	Armenian's	Marianne's
Anshan	Shanna
Anshan's	Shanna's
Antarctic	antarctic
Antigone	negation
Antigone's	negation's
Antipas	patinas
Anzac	Nazca
Aphrodite	atrophied
Apple	apple
Apple's	apple's
Apr	par	rap
Apr's	par's
Aprils	spiral
Ar	Ra
Ar's	Ra's
Arabs	Basra
Aral's	Lara's
Archie	achier
Arctic	arctic
Ares	ares	ears	eras	sear	sera
Argentine	tangerine
Argentine's	tangerine's
Argentines	tangerines
Argus	sugar
Argus's	sugar's
Aries	arise	raise
Aristotelian	retaliations
Ark	ark
Ark's	ark's
Arlene	leaner
Arline	linear
Armani	Marian	Marina	airman	marina
Armani's	Marina's	airman's	marina's
Arnhem	Herman
Arnhem's	Herman's
Arno	Aron	Nora	Oran	roan
Arno's	Aron's	Nora's	Oran's
Arnold	Roland	Ronald
Arnold's	Roland's	Ronald's
Art	art	rat	tar
Art's	art's	rat's	tar's
Artemis	maestri
Artie	irate
As	as
Ashanti	Tanisha
Ashanti's	Tanisha's
Ashe	Shea
Ashe's	Shea's
Ashley	Halsey
Ashley's	Halsey's
Asmara	Samara
Asmara's	Samara's
Asoka	Osaka
Asoka's	Osaka's
Aspell	lapels
Aspen	aspen	napes	panes
Aspen's	aspen's
Assam	amass
Astor	Sarto	roast	sorta	taros
Astor's	Sarto's
Astrakhan	astrakhan
Astrakhan's	astrakhan's
At	Ta	at
At's	Ta's
Atari	Atria	atria	tiara
Atari's	Atria's	tiara's
Athens	hasten
Atlantes	atlantes
Atlas	atlas
Atlas's	atlas's
Atlases	atlases
Atreus	Seurat
Atreus's	Seurat's
Ats	Sat	sat
Attic	attic	tacit
Auden	Duane
Auden's	Duane's
August	august
Augusts	augusts
Austen	unseat
Austin	Unitas
Austin's	Unitas's
Austins	sustain
Australian	Saturnalia
Australian's	Saturnalia's
Autumn	autumn
Autumn's	autumn's
Av	Va
Av's	Va's
Ave	Eva
Ave's	Eva's
Aventine	Venetian
Aves	save	vase
Avila	avail
Avis	Siva	Visa	visa
Avon	Nova	nova
Avon's	Nova's	nova's
Ayers	years
Babel	babel
Babels	babels
Bacon	bacon
Bacon's	bacon's
Baden	baned
Badlands	badlands
Baggies	baggies
Baird	braid	rabid
Baker	baker	brake	break
Baker's	baker's	brake's
Balder	balder	blared
Bali	bail
Bali's	bail's
Balinese	baseline
Ball	ball
Ball's	ball's
Bangor	brogan
Bangor's	brogan's
Bangui	Ubangi
Bangui's	Ubangi's
Banks	banks
Baptist	baptist
Baptists	baptists
Barber	barber
Barber's	barber's
Barbie	babier
Barents	banters
Barker	barker
Barker's	barker's
Barney	nearby
Baroda	aboard	abroad
Bart	brat
Bart's	brat's
Basel	ables	bales	sable
Basel's	sable's
Basil	bails	basil
Basil's	basil's
Bass	bass
Bass's	bass's
Bates	abets	baste	bates	beast	beats	betas
Batman	bantam
Batman's	bantam's
Battle	battle	tablet
Battle's	battle's	tablet's
Batu	abut	tuba
Batu's	tuba's
Be	be
Beach	beach
Beach's	beach's
Bean	bane	bean
Bean's	bane's	bean's
Beard	Debra	bared	beard	bread	debar
Beard's	Debra's	beard's	bread's
Beau	beau
Beau's	beau's
Beck	beck
Beck's	beck's
Begin	begin	being	binge
Begin's	being's	binge's
Bell	bell
Bell's	bell's
Bella	label
Bella's	label's
Bellow	Bowell	bellow
Bellow's	Bowell's
Beltane	tenable
Bender	bender
Bender's	bender's
Bengal	bangle
Bengal's	bangle's
Benton	bonnet
Benton's	bonnet's
Beretta	abetter
Berg	berg
Berg's	berg's
Berger	Gerber
Berger's	Gerber's
Berle	rebel
Bermuda	rumbaed
Berra	barer
Berry	berry
Berry's	berry's
Bert	Bret
Bert's	Bret's
Bertha	bather	breath
Bertha's	bather's	breath's
Beryl	beryl
Beryl's	beryl's
Best	best	bets
Betsy	bytes
Bib	bib
Bib's	bib's
Bible	bible
Bibles	bibles
Biblical	biblical
Bill	bill
Bill's	bill's
Billings	billings
Billy	billy
Billy's	billy's
Bird	bird
Bird's	bird's
Bishop	bishop
Bishop's	bishop's
Black	black
Blacks	blacks
Blair	Libra
Blair's	Libra's
Blake	bleak
Blockbuster	blockbuster
Blockbuster's	blockbuster's
Bloom	bloom
Bloom's	bloom's
Bloomer	bloomer
Bloomer's	bloomer's
Boas	boas
Bob	bob
Bobby	bobby
Bobby's	bobby's
Boer	Ebro	bore	robe
Boer's	Ebro's	robe's
Boers	bores	robes	sober
Bohemian	bohemian
Bohemians	bohemians
Bologna	bologna
Bologna's	bologna's
Bond	bond
Bond's	bond's
Bonita	obtain
Bonnie	bonnie
Booker	Brooke
Booker's	Brooke's
Booth	booth
Booth's	booth's
Born	Brno	born
Born's	Brno's
Borneo	Oberon
Borneo's	Oberon's
Bosnia	bonsai
Bosnia's	bonsai's
Boswell	bellows
Boswell's	bellows's
Boulder	boulder
Boulder's	boulder's
Bourbon	bourbon
Bourbon's	bourbon's
Bowers	bowers	browse
Bowman	bowman
Bowman's	bowman's
Boyd	body
Boyd's	body's
Br	Rb
Brad	bard	brad	drab
Brad's	bard's	brad's
Bradly	drably
Brady	Darby
Brady's	Darby's
Brahe	Haber	rehab
Brahe's	Haber's
Braille	braille	liberal
Brailles	ballsier	liberals
Brain	Brian	Rabin	brain
Brain's	Brian's	Rabin's	brain's
Bran	barn	bran
Bran's	barn's	bran's
Branch	branch
Branch's	branch's
Brandeis	brandies
Branden	Brendan
Branden's	Brendan's
Brandie	bandier	brained
Brandy	brandy
Brandy's	brandy's
Bray	bray
Breton	Bronte
Brewer	brewer
Brewer's	brewer's
Bridges	bridges
Brie	bier
Brie's	bier's
Bright	bright
Britten	bittern
Britten's	bittern's
Brooks	brooks
Brown	brown
Brown's	brown's
Brownie	brownie
Brownie's	brownie's
Brownies	brownies
Browning	browning
Browning's	browning's
Brummel	mumbler
Brummel's	mumbler's
Brut	Burt
Brut's	Burt's
Bryon	Byron	Robyn
Bryon's	Byron's	Robyn's
Btu	but	tub
Buck	buck
Buck's	buck's
Bud	bud	dub
Bud's	bud's
Buddy	buddy
Buddy's	buddy's
Buffalo	buffalo
Buffalo's	buffalo's
Bullock	bullock
Bullock's	bullock's
Bunker	bunker
Bunker's	bunker's
Burger	burger
Burger's	burger's
Burl	blur
Burma	rumba
Burma's	rumba's
Burns	burns
Burr	burr
Burr's	burr's
Bush	bush	hubs
Bush's	bush's
Butler	butler
Butler's	butler's
Butterfingers	butterfingers
Butterfingers's	butterfingers's
Cabinet	cabinet
Cabinets	cabinets
Caedmon	Macedon
Caedmon's	Macedon's
Caesarean	caesarean
Caesareans	caesareans
Cage	cage
Cage's	cage's
Cagney	agency
Cagney's	agency's
Cain	Inca
Cain's	Inca's
Cains	Incas
Calder	cradle
Calder's	cradle's
Calderon	colander
Calderon's	colander's
Caleb	cable
Caleb's	cable's
Calliope	calliope
Calliope's	calliope's
Callisto	Castillo
Callisto's	Castillo's
Calvary	cavalry
Calvary's	cavalry's
Camel	camel
Camel's	camel's
Cameron	romance
Cameron's	romance's
Camry	Marcy
Camry's	Marcy's
Camus	sumac
Camus's	sumac's
Canaries	canaries
Cancer	cancer
Cancer's	cancer's
Cancers	cancers
Candide	candied
Candy	candy
Candy's	candy's
Cannon	cannon
Cannon's	cannon's
Canon	Conan	canon
Canon's	Conan's	canon's
Canton	cannot	canton
Canton's	canton's
Cantor	Carnot	cantor	carton
Cantor's	Carnot's	cantor's	carton's
Capella	Laplace
Capella's	Laplace's
Caph	chap
Capitol	capitol	optical	topical
Capitols	capitols
Capri	carpi
Capt	pact
Capt's	pact's
Cardin	rancid
Carina	crania
Carla	Clara
Carla's	Clara's
Carlene	cleaner
Carlene's	cleaner's
Carlo	Carol	carol	coral
Carlo's	Carol's	carol's	coral's
Carlos	carols	corals
Carly	Lycra
Carlyle	clearly
Carmela	caramel
Carmela's	caramel's
Carmella	Marcella
Carmella's	Marcella's
Carmelo	Marcelo
Carmelo's	Marcelo's
Carmine	Crimean	carmine
Carmine's	carmine's
Carnation	carnation
Carnation's	carnation's
Carole	oracle
Carole's	oracle's
Caroline	Cornelia
Carpenter	carpenter
Carpenter's	carpenter's
Carrie	racier
Carrier	carrier
Carrier's	carrier's
Carson	acorns
Carter	Crater	crater	tracer
Carter's	Crater's	crater's	tracer's
Cartesian	ascertain	sectarian
Cartier	erratic
Carver	carver
Carver's	carver's
Cary	Cray	racy
Cary's	Cray's
Cascades	cascades
Case	aces	case
Case's	case's
Cash	cash
Cash's	cash's
Castor	Castro	Croats	actors	castor	costar	scrota
Castor's	Castro's	castor's
Castries	scariest
Caterpillar	caterpillar
Cather	Thrace
Cather's	Thrace's
Catholic	catholic
Catholics	catholics
Cathy	yacht
Cathy's	yacht's
Cato	coat	taco
Cato's	coat's	taco's
Catt	tact
Catt's	tact's
Cayenne	cayenne
Cayenne's	cayenne's
Cebu	cube
Cebu's	cube's
Celsius	sluices
Centigrade	centigrade
Cesar	acres	cares	races	scare
Cesarean	cesarean
Cetus	cutes
Ceylon	Conley
Ceylon's	Conley's
Chaitin	Chianti
Challenger	challenger
Challenger's	challenger's
Chamberlain	chamberlain
Chamberlain's	chamberlain's
Chambers	chambers
Chance	chance
Chance's	chance's
Chandler	chandler
Chandler's	chandler's
Chandra	handcar
Chandra's	handcar's
Charity	charity
Charity's	charity's
Charles	larches
Charon	anchor
Charon's	anchor's
Chartres	charters
Chase	aches	chase
Chasity	Scythia
Chasity's	Scythia's
Cheddar	cheddar
Cheer	cheer
Chelsea	leaches
Cheops	epochs
Cheri	Erich	Reich
Cheri's	Erich's	Reich's
Cherry	cherry
Cherry's	cherry's
Chester	etchers	retches
Chevron	chevron
Chevron's	chevron's
Chi	chi
Chi's	chi's
Chile	chile
Chile's	chile's
Chimera	chimera
China	Icahn	chain	china
China's	Icahn's	chain's	china's
Chopin	phonic
Chou	ouch
Christian	Christina
Christian's	Christina's
Chuck	chuck
Church	church
Church's	church's
Claire	lacier
Clare	clear
Claus	Lucas
Clay	Lacy	clay	lacy
Clay's	Lacy's	clay's
Clement	clement
Clemons	Clemson
Cleo	Cole
Cleo's	Cole's
Cliff	cliff
Cliff's	cliff's
Clio	coil	loci
Clio's	loci's
Cochise	choices
Cockney	cockney
Cognac	cognac
Cognac's	cognac's
Cohan	nacho
Cohen	Enoch
Cohen's	Enoch's
Coke	coke
Coke's	coke's
Cokes	cokes
Colleen	colleen
Colleen's	colleen's
Collier	collier
Collier's	collier's
Colo	cool	loco
Colo's	loco's
Cologne	cologne
Cologne's	cologne's
Colon	colon
Colon's	colon's
Colt	clot	colt
Colt's	clot's	colt's
Columbine	columbine
Columbine's	columbine's
Comanche	coachmen
Combs	combs
Commons	commons
Commons's	commons's
Commonwealth	commonwealth
Commonwealth's	commonwealth's
Commonwealths	commonwealths
Communion	communion
Communion's	communion's
Communions	communions
Communism	communism
Communist	communist
Communists	communists
Comte	comet
Comte's	comet's
Concord	concord
Concord's	concord's
Confederacy	confederacy
Confederacy's	confederacy's
Confederate	confederate
Confederates	confederates
Congress	congress
Congress's	congress's
Congresses	congresses
Congreve	converge
Conrad	Dacron	candor
Conrad's	Dacron's	candor's
Conrail	clarion
Conrail's	clarion's
Constable	constable
Constable's	constable's
Constitution	constitution
Continent	continent
Continent's	continent's
Continental	continental
Cook	cook
Cook's	cook's
Cooper	cooper
Cooper's	cooper's
Corey	Royce	coyer
Corey's	Royce's
Corine	Enrico
Corine's	Enrico's
Cornelius	inclosure
Cornelius's	inclosure's
Corning	corning
Corrine	cornier
Cortes	corset	escort	sector
Cossack	cassock
Cossack's	cassock's
Cossacks	cassocks
Costner	cornets
Cote	cote
Cote's	cote's
Cotton	cotton
Cotton's	cotton's
Coward	coward
Coward's	coward's
Cox	cox
Cox's	cox's
Coy	coy
Craft	craft
Craft's	craft's
Craig	cigar
Craig's	cigar's
Crane	crane	nacre
Crane's	crane's	nacre's
Creation	creation	reaction
Creation's	creation's	reaction's
Creator	creator	reactor
Creator's	creator's	reactor's
Creek	creek
Creek's	creek's
Creighton	hectoring
Creole	creole
Creole's	creole's
Creoles	creoles
Creon	crone
Creon's	crone's
Crest	crest
Crest's	crest's
Cretan	canter	nectar	recant	trance
Crete	erect
Crick	crick
Crick's	crick's
Crimea	Marcie	Mercia
Crimea's	Marcie's	Mercia's
Croat	actor
Croat's	actor's
Croatian	raincoat
Croatians	raincoats
Croesus	courses	sources	sucrose
Croesus's	sucrose's
Crookes	cookers
Cross	cross
Cross's	cross's
Cruise	cruise	curies
Crusades	crusades
Crusoe	course	source
Crusoe's	course's	source's
Crux	crux
Crux's	crux's
Crystal	crystal
Crystal's	crystal's
Cs	Sc	cs
Ctesiphon	phonetics
Ctesiphon's	phonetics's
Cummings	scumming
Curie	curie
Curie's	curie's
Curry	curry
Curry's	curry's
Curt	curt
Curtis	citrus	rustic
Curtis's	citrus's
Custer	cruets	truces
Cyrano	crayon
Cyrano's	crayon's
Cyril	lyric
Daisy	daisy
Daisy's	daisy's
Dale	Leda	dale	deal	lade	lead
Dale's	Leda's	dale's
Daley	delay
Dali	Dial	dial	laid
Dali's	Dial's	dial's
Dalian	Danial
Dalian's	Danial's
Dalmatian	dalmatian
Dalmatians	dalmatians
Damien	Medina	maiden	median
Damien's	Medina's	maiden's
Damion	domain
Damion's	domain's
Damon	nomad
Damon's	nomad's
Dan	and
Daniel	denial	nailed
Daniel's	denial's
Daniels	denials	snailed
Dannie	Dianne	Nadine
Dannie's	Dianne's	Nadine's
Dante	anted
Dare	dare	dear	read
Darin	Indra	Randi	drain	nadir
Darin's	Indra's	Randi's	drain's	nadir's
Dario	radio
Dario's	radio's
Darius	radius
Darius's	radius's
Darlene	Leander	learned
Darlene's	Leander's
Darling	darling	larding
Darling's	darling's
Darnell	Randell
Darnell's	Randell's
Darrel	larder
Darrel's	larder's
Darren	errand
Darren's	errand's
Darwin	inward
Dave	Veda
Dave's	Veda's
Davenport	davenport
Davenport's	davenport's
Davies	advise	visaed
Davis	divas
Dawes	sawed	wades
Dawn	dawn	wand
Dawn's	dawn's	wand's
Day	day
Day's	day's
Debs	beds	debs
Decatur	curated	traduce
Deidre	deride
Deity	deity
Deity's	deity's
Del	led
Delano	loaned
Delbert	trebled
Delia	ailed	ideal
Delia's	ideal's
Delibes	edibles
Delicious	delicious
Della	ladle
Della's	ladle's
Deloris	soldier	solider
Deloris's	soldier's
Delta	dealt	delta
Delta's	delta's
Demerol	remodel
Demeter	metered
Democrat	democrat
Democrat's	democrat's
Democratic	democratic
Democrats	democrats
Denis	dines	snide
Denise	denies
Dennis	sinned
Denver	nerved	vender
Denver's	vender's
Deon	done	node
Deon's	node's
Derbies	derbies
Derby	derby
Derby's	derby's
Derick	dicker	ricked
Derrick	derrick
Derrick's	derrick's
Desiree	seedier
Devi	dive	vied
Devin	vined
Dewar	wader
Dewar's	wader's
Dewey	weedy
Di	id
Di's	id's
Diana	Nadia	naiad
Diana's	Nadia's	naiad's
Dick	dick
Dick's	dick's
Diego	dogie
Diego's	dogie's
Diem	dime
Diem's	dime's
Diesel	diesel	elides
Diesel's	diesel's
Dilbert	driblet
Dilbert's	driblet's
Dino	Dion	Odin
Dino's	Dion's	Odin's
Dionne	Donnie
Dionne's	Donnie's
Dipper	dipper	ripped
Dipper's	dipper's
Dirac	acrid
Dirk	dirk
Dirk's	dirk's
Dis	Sid	dis	ids
Disney	Sidney
Disney's	Sidney's
Dnieper	ripened
Dniester	inserted	nerdiest	resident	trendies
Dniester's	resident's
Dobro	brood
Dobro's	brood's
Doctor	doctor
Dodge	dodge
Doe	doe	ode
Doe's	doe's	ode's
Dole	dole	lode
Dole's	dole's	lode's
Dolly	Lloyd	dolly
Dolly's	Lloyd's	dolly's
Domingo	dooming
Don	don	nod
Dora	road
Dora's	road's
Doreen	redone
Dorian	inroad	ordain
Dorian's	inroad's
Dorothea	Theodora
Dorothea's	Theodora's
Dorset	sorted	stored	strode	trodes
Dot	Tod	dot
Dot's	Tod's	dot's
Dover	drove	roved
Downs	downs
Downy	downy
Doyle	yodel
Dr	Rd
Dr's	Rd's
Draconian	draconian
Drake	drake	raked
Drake's	drake's
Drano	NORAD	Ronda	adorn	radon
Drano's	NORAD's	Ronda's	radon's
Dreiser	serried
Dresden	reddens
Drew	drew
Druid	druid
Druid's	druid's
Dubcek	bucked
Duke	duke
Duke's	duke's
Dumpster	dumpster
Dunbar	Durban
Dunbar's	Durban's
Dunlap	upland
Dunlap's	upland's
Durant	tundra
Durant's	tundra's
Durante	natured
Duse	dues	sued	used
Dustin	nudist
Dustin's	nudist's
Dusty	dusty	study
Dvina	divan	viand
Dvina's	divan's	viand's
Dwayne	yawned
Dyer	dyer
Dyer's	dyer's
Dylan	Lynda
Dylan's	Lynda's
Dyson	synod
Dyson's	synod's
Earl	Lear	earl	real
Earl's	Lear's	earl's
Earnest	Eastern	earnest	eastern	nearest
Earp	pare	pear	rape	reap
Earp's	pear's	rape's
Earth	Harte	earth	hater	heart
East	ates	east	eats	sate	seat	teas
East's	east's	seat's
Easter	Teresa	eaters	teaser
Easter's	Teresa's	teaser's
Easterner	easterner
Easterner's	easterner's
Easterners	easterners
Easters	teasers
Eastman	Smetana
Eastman's	Smetana's
Easts	Tessa	asset	sates	seats
Eaton	atone	oaten
Eben	been
Ebert	beret
Ebert's	beret's
Ebony	boney	ebony
Ebony's	ebony's
Edam	Mead	dame	made	mead
Edam's	Mead's	dame's	mead's
Edams	dames
Edda	dead
Eddy	dyed	eddy
Eddy's	eddy's
Eden	need
Edens	dense	needs
Edgar	grade	raged
Edgar's	grade's
Edison	noised
Edsel	Leeds
Edsel's	Leeds's
Edward	warded
Edwin	Wendi	widen	wined
Edwin's	Wendi's
Efrain	fainer
Einstein	nineties
Eire	Erie
Eire's	Erie's
Elam	Elma	Male	lame	male	meal
Elam's	Elma's	Male's	meal's
Elanor	Elnora	Lenora	Lorena	loaner
Elanor's	Elnora's	Lenora's	Lorena's	loaner's
Elbert	treble
Elbrus	rubles
Eldon	olden
Electra	treacle
Electra's	treacle's
Eli	Lie	lei	lie
Eli's	Lie's	lei's
Elias	Elisa	aisle
Elinor	Lenoir
Elinor's	Lenoir's
Elisa's	aisle's
Elise	Elsie
Elise's	Elsie's
Eliseo	Eloise
Eliseo's	Eloise's
Elisha	Sheila	Shelia
Elisha's	Sheila's	Shelia's
Ella	Lela
Ella's	Lela's
Ellis	lisle
Elmer	Merle
Elmer's	Merle's
Elmo	Lome	mole
Elmo's	mole's
Elroy	Leroy
Elroy's	Leroy's
Elsa	Lesa	ales	leas	sale	seal
Elsa's	Lesa's	sale's	seal's
Elva	Vela	vale	veal
Elva's	Vela's	vale's	veal's
Elvia	alive
Elvin	liven
Elvis	evils	lives	veils
Elvis's	lives's
Emacs	Maces	acmes	maces
Emery	Meyer	emery
Emery's	Meyer's	emery's
Emil	lime	mile
Emil's	lime's	mile's
Eng	Gen
Eng's	Gen's
English	shingle
English's	shingle's
Enid	dine
Enif	fine
Enif's	fine's
Enos	eons	noes	nose	ones
Enrique	enquire
Enterprise	enterprise
Enterprise's	enterprise's
Epicurean	epicurean
Episcopal	episcopal
Epsom	mopes	poems
Er	Re	re
Er's	Re's	re's
Erasmus	masseur
Erasmus's	masseur's
Erato	orate
Erhard	harder
Eric	Rice	rice
Eric's	Rice's	rice's
Ericson	cronies
Erik	Keri
Erik's	Keri's
Erin	rein
Erin's	rein's
Eris	ires	rise	sire
Eritrea	tearier
Erma	mare	ream
Erma's	mare's	ream's
Erna	Rena	earn	near
Erna's	Rena's
Ernest	Sterne	enters	resent	tenser
Ernest's	Sterne's
Ernestine	internees
Ernie	Irene
Ernie's	Irene's
Ernst	Stern	rents	stern	terns
Ernst's	Stern's
Eros	Rose	ores	roes	rose	sore
Eros's	Rose's	rose's
Errol	Lorre
Errol's	Lorre's
Erse	seer	sere
Erse's	seer's
ErvIn	riven
Es	Se	es
Escher	cheers
Eskimos	smokies
Essen	sense
Essen's	sense's
Essequibo	obsequies
Essex	sexes
Establishment	establishment
Establishment's	establishment's
Establishments	establishments
Estela	elates	teasel
Estela's	teasel's
Ester	ester	reset	steer	terse	trees
Ester's	ester's
Esther	Hester	threes
Esther's	Hester's
Estonians	sensation
Ethan	neath
Ethel	Lethe
Ethel's	Lethe's
Etna	Nate	ante	neat
Etna's	Nate's	ante's
Eton	note	tone
Eton's	note's	tone's
Etruscan	centaurs
Etta	Tate	teat
Etta's	Tate's	teat's
Eula	Laue
Eula's	Laue's
Evan	Neva	nave	vane
Evan's	Neva's	nave's	vane's
Evans	naves	vanes
Eve	eve
Eve's	eve's
Evelyn	evenly
Everglades	everglades
Evian	naive
Exodus	exodus
Exodus's	exodus's
Eyre	eery
Ezra	raze
Faith	faith
Faith's	faith's
Fannie	Fenian
Fannie's	Fenian's
Fanny	fanny
Fanny's	fanny's
Farmer	farmer	framer
Farmer's	farmer's	framer's
Farrow	farrow
Farrow's	farrow's
Farsi	fairs
Fates	fates	feast	feats
Father	father
Father's	father's
Fathers	fathers
Fed	fed
Federalist	federalist
Feds	feds
Felicity	felicity
Felicity's	felicity's
Fern	Nerf	fern
Fern's	fern's
Fez	fez
Fez's	fez's
Fiat	fiat
Fiat's	fiat's
Fidel	field	filed	flied
Fidel's	field's
Fielding	defiling	fielding
Fields	fields
Finch	finch
Finch's	finch's
Finley	finely
Fisher	fisher
Fisher's	fisher's
Flemish	himself
Flint	flint
Flint's	flint's
Flora	flora
Flora's	flora's
Flowers	flowers
Folgers	golfers
Ford	ford
Ford's	ford's
Foreman	foreman
Foreman's	foreman's
Forest	Foster	forest	fortes	foster	softer
Forest's	Foster's	forest's
Forester	forester	reforest
Forester's	forester's
Forrest	Forster
Forrest's	Forster's
Fowler	flower
Fowler's	flower's
Fox	fox
Fox's	fox's
Frank	frank
Frankfurter	frankfurter
Frankfurter's	frankfurter's
Franks	franks
Freda	fared
Freeman	freeman
Freeman's	freeman's
Freemason	forenames
Freetown	forewent
Freida	Frieda
Freida's	Frieda's
French	french
Frey	Frye
Frey's	Frye's
Fri	fir
Fri's	fir's
Fronde	fonder
Frost	forts	frost
Frost's	frost's
Fry	fry
Fuller	fuller
Fuller's	fuller's
GE	Ge
GE's	Ge's
GTE	get
Gable	bagel	gable
Gable's	bagel's	gable's
Gael	Gale	gale
Gael's	Gale's	gale's
Gage	gage
Gage's	gage's
Gail	Gila
Gail's	Gila's
Gaines	easing
Gaines's	easing's
Gall	gall
Gall's	gall's
Galvani	vaginal
Gamble	gamble
Gandhi	hading
Gantry	gantry
Gantry's	gantry's
Gap	gap
Gap's	gap's
Gardner	grander
Gareth	gather
Garland	garland
Garland's	garland's
Garner	garner	ranger
Garner's	ranger's
Garrison	garrison
Garrison's	garrison's
Gary	Gray	gray
Gary's	Gray's
Gates	gates	stage
Gatun	gaunt
Gay	gay
Geiger	Reggie
Geiger's	Reggie's
Genaro	Orange	orange
Genaro's	Orange's	orange's
Gene	gene
Gene's	gene's
Genesis	genesis	seeings
Genesis's	genesis's
Geneva	avenge
Genoa	Onega
Genoa's	Onega's
Gentry	gentry
Gentry's	gentry's
Geo	ego
Geo's	ego's
Georgian	Georgina
Ger	erg
Ger's	erg's
Gerald	glared
Gerard	grader	regard
Gerard's	grader's
German	manger
German's	manger's
Germanic	creaming
Germans	mangers
Gershwin	shrewing
Gestapo	postage
Gestapo's	postage's
Gibbon	gibbon
Gibbon's	gibbon's
Gill	gill
Gill's	gill's
Ginger	ginger	nigger
Ginger's	ginger's	nigger's
Ginsu	suing	using
Gipsy	gipsy
Gish	sigh
Glaser	glares	lagers	larges	regals
Glass	glass	slags
Glass's	glass's
Glen	glen
Glen's	glen's
Glenda	angled	dangle
Glover	grovel
Gnostic	costing
Goa	ago
God	dog	god
God's	dog's	god's
Golden	golden	longed
Golding	lodging
Golding's	lodging's
Goldsmith	goldsmith
Goldsmith's	goldsmith's
Good	good
Goodwill	goodwill
Goodwill's	goodwill's
Goodwin	wooding
Gopher	gopher
Gordian	adoring
Gore	Roeg	ergo	gore	ogre
Gore's	Roeg's	gore's	ogre's
Goren	Negro	goner
Goren's	Negro's	goner's
Gospel	gospel
Gospel's	gospel's
Gospels	gospels
Goths	ghost
Goya	yoga
Goya's	yoga's
Grace	grace
Grace's	grace's
Gracie	cagier
Grail	grail
Grant	grant
Grass	grass
Grass's	grass's
Graves	graves
Grecians	creasing
Greeks	Kresge
Green	genre	green
Green's	genre's	green's
Greene	renege
Grenadines	serenading
Greta	grate	great
Grey	grey
Griffin	griffin	riffing
Griffin's	griffin's
Grimes	grimes
Gris	rigs
Gross	gross
Grus	rugs
Guiana	iguana
Guiana's	iguana's
Guinea	guinea
Guinea's	guinea's
Guineans	sanguine
Guy	guy
Guy's	guy's
Gypsies	gypsies
Gypsy	gypsy
Haas	ahas
Hades	ashed	hades	heads	shade
Hale	Leah	hale	heal
Hale's	Leah's
Hall	hall
Hall's	hall's
Hallmark	hallmark
Hallmark's	hallmark's
Halon	halon
Hals	lash
Ham	ham
Ham's	ham's
Hamlet	Thelma	hamlet
Hamlet's	Thelma's	hamlet's
Hampton	phantom
Hampton's	phantom's
Hamsun	humans
Handel	handle
Handel's	handle's
Handy	Haydn	handy
Handy's	Haydn's
Haney	hyena
Haney's	hyena's
Hank	Khan	ankh	hank	khan
Hank's	Khan's	ankh's	hank's	khan's
Hans	Nash
Hansen	hennas
Hardy	Hydra	hardy	hydra
Hardy's	Hydra's	hydra's
Harlem	Mahler
Harlem's	Mahler's
Harlequin	harlequin
Harlow	Warhol
Harlow's	Warhol's
Harry	harry
Hart	Thar	hart
Hart's	Thar's	hart's
Harte's	earth's	hater's	heart's
Hasbro	abhors
Hastings	stashing
Havel	halve
Hawking	hawking
Hay	hay
Hay's	hay's
Hayes	yeahs
Haynes	hyenas
Hays	ashy	hays
Hazel	hazel
Hazel's	hazel's
He	eh	he
He's	he's
Head	head
Head's	head's
Hearst	earths	haters	hearts
Heath	heath
Heath's	heath's
Heather	heather
Heather's	heather's
Hector	hector
Helicon	Nichole
Helicon's	Nichole's
Hell	hell
Hell's	hell's	she'll
Hellenic	chenille
Hells	hells	shell
Henri	Rhine
Henri's	Rhine's
Hera	Rhea	hare	hear	rhea
Hera's	Rhea's	hare's	rhea's
Hermitage	hermitage
Hermitage's	hermitage's
Herod	horde
Herod's	horde's
Herring	herring
Herring's	herring's
Hersey	heresy
Hersey's	heresy's
Hertz	hertz
Hertz's	hertz's
Hess	shes
Heston	honest
Hicks	hicks
Higgins	sighing
Highness	highness
Highness's	highness's
Hilbert	blither
Hill	hill
Hill's	hill's
Hines	shine
Hiss	hiss
Hiss's	hiss's
Hitler	lither
Hitlers	slither
Ho	ho	oh
Hogan	hogan
Hogan's	hogan's
Hogwarts	warthogs
Holder	holder
Holder's	holder's
Holiday	holiday
Holiday's	holiday's
Holly	holly
Holly's	holly's
Holocaust	holocaust
Holst	sloth
Holst's	sloth's
Holt	loth
Homer	homer
Homer's	homer's
Hon	Noh
Hon's	Noh's
Hood	hood
Hood's	hood's
Hooker	hooker
Hooker's	hooker's
Hooters	hooters	shooter	soother
Hooters's	shooter's
Hope	hope
Hope's	hope's
Hopper	hopper
Hopper's	hopper's
Horn	horn
Horn's	horn's
Horne	Rhone	heron	honer
Horne's	heron's
Horus	hours
House	house
House's	house's
Hudson	hounds
Huff	huff
Huff's	huff's
Huggins	gushing
Hull	hull
Hull's	hull's
Hung	hung
Huns	shun
Hunt	hunt
Hunter	hunter
Hunter's	hunter's
Hurons	onrush
Hurst	Thurs	hurts
Hymen	hymen
Hymen's	hymen's
Ian	Ina	ani
Ian's	Ina's
Ida	aid
Iliad	Lidia
Iliad's	Lidia's
Ill	ill
Imelda	mailed	medial
In	Ni	in
In's	Ni's
Ind	din
Ind's	din's
Independence	independence
Independence's	independence's
Indies	inside
Indore	ironed
Ines	sine
Ingram	arming	margin
Ingram's	margin's
Ingres	Singer	reigns	resign	sering	signer	singer
Ingres's	Singer's	singer's
Ingrid	riding
Ingrid's	riding's
Innocent	innocent
Inonu	Union	union
Inonu's	Union's	union's
Inquisition	inquisition
Inquisition's	inquisition's
Intel	inlet
Intel's	inlet's
Ira	air
Ira's	air's
Iran	Nair	rain
Iran's	Nair's	rain's
Iris	iris
Irma	Mari	Mira
Irma's	Mari's	Mira's
Irtish	Tishri
Irtish's	Tishri's
Irving	virgin
Irving's	virgin's
Ishtar	Trisha
Ishtar's	Trisha's
Islam	mails
Islams	missal
Ismael	Melisa	emails
Ismael's	Melisa's
Isolde	oldies	soiled
Israel	serial
Israel's	serial's
Israelite	realities
Israels	airless	serials
It	Ti	it	ti
Italy	laity
Italy's	laity's
Ithacan	acanthi
Iva	via
Ivan	vain
Ives	vies	vise
Ivory	ivory
Ivory's	ivory's
Ivy	ivy
Ivy's	ivy's
Iyar	airy
Jack	jack
Jack's	jack's
Jaguar	jaguar
Jaguar's	jaguar's
Jaime	Jamie	Mejia
Jaime's	Jamie's	Mejia's
Jane	Jean
Jane's	Jean's
Janine	Jannie
Janine's	Jannie's
Japan	japan
Japan's	japan's
Jarred	jarred
Jasmine	jasmine
Jasmine's	jasmine's
Jason	Jonas	Sonja
Jason's	Sonja's
Jasper	jasper
Jasper's	jasper's
Jay	jay
Jay's	jay's
Jeanine	Jeannie
Jeanine's	Jeannie's
Jeep	jeep
Jeeps	jeeps
Jeffery	Jeffrey
Jeffery's	Jeffrey's
Jersey	jersey
Jersey's	jersey's
Jerseys	jerseys
Jewel	jewel
Jewel's	jewel's
Jimmy	jimmy
Jimmy's	jimmy's
Jinan	ninja
Job	job
Job's	job's
Jobs	jobs
Jock	jock
Jock's	jock's
Jockey	jockey
Joesph	Joseph
Joesph's	Joseph's
John	john
John's	john's
Johns	johns
Joni	join
Josh	josh
Joule	joule
Joule's	joule's
Joy	joy
Joy's	joy's
Juanita	Tijuana
Juanita's	Tijuana's
Juggernaut	juggernaut
Juggernaut's	juggernaut's
Junior	junior
Juniors	juniors
Justice	justice
Justice's	justice's
Kalb	balk
Kans	sank
Kant	tank
Kant's	tank's
Kareem	remake
Kareem's	remake's
Karl	lark
Karl's	lark's
Karo	okra
Karo's	okra's
Kasai	Sakai
Kasai's	Sakai's
Kate	take	teak
Kate's	teak's
Katmai	Tamika
Katmai's	Tamika's
Kay	yak
Kay's	yak's
Keats	skate	stake	steak	takes	teaks
Keats's	skate's	stake's	steak's
Keith	Kieth
Keith's	Kieth's
Ken	ken
Ken's	ken's
Kendra	danker	darken	narked	ranked
Key	key
Key's	key's
Kiel	like
King	king
King's	king's
Kirk	kirk
Kirk's	kirk's
Kirsten	Kristen	stinker	tinkers
Kirsten's	Kristen's	stinker's
Kit	kit
Kit's	kit's
Kitchener	thickener
Kitchener's	thickener's
Kitty	kitty
Kitty's	kitty's
Klan	lank
Klee	keel	leek
Klee's	keel's	leek's
Klein	Kline	liken
Klein's	Kline's
Knight	knight
Knight's	knight's
Koch	hock
Koch's	hock's
Kory	York
Kory's	York's
Kramer	marker	remark
Kramer's	marker's
Kris	irks	risk
Kris's	risk's
Kroc	Rock	cork	rock
Kroc's	Rock's	cork's	rock's
Krystal	starkly
Kuhn	hunk
Kuhn's	hunk's
Kurt	Turk
Kurt's	Turk's
Kusch	shuck
Kusch's	shuck's
Kyoto	Tokyo
Kyoto's	Tokyo's
Laban	banal
Labrador	larboard
Labrador's	larboard's
Labradors	larboards
Lagos	gaols	goals
Laius	Luisa
Laius's	Luisa's
Lamar	Marla	alarm
Lamar's	Marla's
Lamb	balm	lamb
Lamb's	balm's	lamb's
Lancaster	ancestral
Lance	clean	lance
Lance's	lance's
Land	land
Land's	land's
Lane	Lean	Lena	Neal	lane	lean
Lane's	Lean's	Lena's	Neal's	lane's
Laos	also
Laredo	loader	ordeal	reload
Laredo's	loader's	ordeal's	reload's
Larsen	learns
Lassa	Salas	salsa
Lassa's	Salas's
Lassie	aisles	lassie
Lassie's	lassie's
Latiner	latrine	reliant	retinal
Latins	Stalin	instal
Latvian	valiant
Laud	dual	laud
Laura	aural
Laurel	allure	laurel
Laurel's	laurel's
Lauren	neural	unreal
Laurence	cerulean
Laurence's	cerulean's
Laurent	Renault	neutral
Laurent's	Renault's
Lauri	Luria
Lauri's	Luria's
Lavern	vernal
Layamon	anomaly
Layamon's	anomaly's
Layla	allay
Lea	ale	lea
Lea's	ale's	lea's
Leach	leach
Leanna	anneal
Leary	early	layer	relay
Leary's	layer's	relay's
Lee	eel	lee
Lee's	eel's	lee's
Leeward	leeward
Left	felt	left
Lefts	felts	lefts
Lego	loge	ogle
Lego's	loge's
Leif	file	lief	life
Leif's	file's	life's
Lenard	lander
Lenin	linen
Lenin's	linen's
Lenny	Lynne
Lenny's	Lynne's
Leno	Leon	Noel	Olen	lone	noel
Leno's	Leon's	Noel's	Olen's
Lenore	Lorene
Lenore's	Lorene's
Lent	lent
Leona	Oneal	alone
Leona's	Oneal's
Leonel	Noelle
Leonel's	Noelle's
Leos	lose	sloe	sole
Lepus	pulse
Lepus's	pulse's
Les	les
Lestrade	treadles
Leta	late	tale	teal
Leta's	tale's	teal's
Letha	lathe
Letha's	lathe's
Levi	evil	live	veil	vile
Levi's	veil's
Leviathan	leviathan
Levy	levy
Lewis	wiles
Lhotse	helots	hostel	hotels
Lhotse's	hostel's
Liege	liege
Lily	lily
Lily's	lily's
Lima	Mali	mail
Lima's	Mali's	mail's
Lin	nil
Lin's	nil's
Lina	lain	nail
Lina's	nail's
Lisa	ails	sail
Lisa's	sail's
Lister	liters
Listerine	resilient
Liston	tonsil
Liston's	tonsil's
Little	little
Loafer	florae	loafer
Loafers	loafers
Lodge	lodge	ogled
Lodge's	lodge's
Loire	Lorie
Loire's	Lorie's
Lois	oils	silo	soil	soli
Lois's	silo's	soil's
Loki	kilo
Loki's	kilo's
Long	long
Longstreet	lorgnettes
Lonnie	online
Lora	oral
Loraine	aileron
Loraine's	aileron's
Lord	lord
Lord's	lord's
Lords	lords
Loren	enrol	loner
Loren's	loner's
Lori	roil
Lot	lot
Lottie	toilet
Lottie's	toilet's
Louvre	louver
Louvre's	louver's	velour's
Love	love	vole
Love's	vole's
Lt	Tl
Lt's	Tl's
Luann	annul
Luce	clue
Luce's	clue's
Lucien	nuclei
Lucien's	nuclei's
Luddite	diluted
Luger	gruel
Luger's	gruel's
Luna	ulna
Luna's	ulna's
Lupus	lupus
Lupus's	lupus's
Luther	hurtle
Lydia	daily
Lyle	yell
Lyman	manly
Lynch	lynch
Lyon	only
MIT	Tim
MIT's	Tim's
Mabel	Mable	Melba	amble	blame
Mabel's	Mable's	Melba's	blame's
Mac	cam
Mac's	cam's
Mace	acme	came	mace
Mace's	acme's	mace's
Maced	maced
Machs	chasm
Macing	macing
Macintosh	macintosh
Macintosh's	macintosh's
Mackinaw	mackinaw
Madden	damned	demand	madden
Madge	gamed
Madison	domains
Madras	dramas	madras
Maginot	moating
Mai	Mia	aim
Mai's	Mia's
Maigret	migrate	ragtime
Maigret's	ragtime's
Mailer	mailer
Mailer's	mailer's
Maj	jam
Major	major
Major's	major's
Malian	Manila	animal
Malians	Manilas	animals
Malibu	labium
Mallory	morally
Mammon	mammon
Mammon's	mammon's
Man	Nam	man
Man's	Nam's	man's
Mandarin	mandarin
Manet	meant
Mani	main
Manila's	animal's
Manley	laymen	meanly	namely
Manning	manning
Mantle	lament	mantel	mantle	mental
Mantle's	mantel's	mantle's
Manuela	alumnae
Maoism	Mimosa	mimosa
Maoism's	Mimosa's	mimosa's
Maoisms	mimosas
Maoist	Taoism
Maoists	Taoisms
Maori	Mario	Moira
Maori's	Mario's	Moira's
Mar	arm	mar	ram
Mar's	arm's	ram's
Mara	Rama
Mara's	Rama's
Marat	Marta	Tamra
Marat's	Marta's	Tamra's
Marathon	marathon
Marathon's	marathon's
Marc	cram
Marcel	calmer
March	charm	march
March's	charm's
Marches	marches
Marci	micra
Marciano	macaroni
Marciano's	macaroni's
Marco	carom	macro
Marco's	carom's	macro's
Marcos	caroms	macros
Margarita	margarita
Margarita's	margarita's
Marge	gamer
Margie	gamier	mirage
Margie's	mirage's
Maria	maria
Maria's	maria's
Mariano	Romania
Mariano's	Romania's
Maribel	balmier
Marine	airmen	marine	remain
Marines	marines	remains	seminar
Mark	mark
Mark's	mark's
Marks	marks
Marlin	marlin
Marlin's	marlin's
Marlon	Molnar	normal
Marlon's	Molnar's
Marple	Palmer	ampler
Marple's	Palmer's
Marquis	marquis
Marquis's	marquis's
Mars	arms	mars	rams
Marsh	harms	marsh
Marsh's	marsh's
Marsha	ashram
Marsha's	ashram's
Martel	armlet
Martel's	armlet's
Martial	marital	martial
Martian	Martina
Martin	martin
Martin's	martin's
Mary	Myra	army
Mary's	Myra's	army's
Maseru	Mauser
Maseru's	Mauser's
Mason	Osman	mason	moans
Mason's	Osman's	mason's
Masonic	masonic
Masons	Samson	masons
Mass	mass
Massenet	tameness
Masses	masses
Masters	masters	streams
Matt	matt
Mauro	amour
Mauro's	amour's
Mayflower	mayflower
Mayflower's	mayflower's
Mayo	mayo
Mays	yams
Mbini	nimbi
Meade	Medea	edema
Meade's	Medea's	edema's
Meadows	meadows
Meagan	manage
Mecca	mecca
Meccas	meccas
Medan	admen	amend	named
Medan's	named's
Media	aimed	media
Media's	media's
Medusa	amused
Meg	gem	meg
Meg's	gem's	meg's
Megan	mange
Megan's	mange's
Meir	emir	mire	rime
Meir's	emir's	mire's	rime's
Mel	elm
Mel's	elm's
Melissa	aimless
Melody	melody
Melody's	melody's
Melton	molten
Melva	Velma
Melva's	Velma's
Memling	lemming
Memling's	lemming's
Menander	mannered
Menes	semen
Menes's	semen's
Mensa	amens	manes	manse	means	names
Mensa's	manse's	means's
Merak	maker
Merak's	maker's
Mercado	caromed	comrade
Mercado's	comrade's
Mercury	mercury
Mercury's	mercury's
Merino	merino
Merton	mentor
Merton's	mentor's
Mervin	vermin
Mervin's	vermin's
Mesa	mesa	same	seam
Messiah	messiah
Messiahs	messiahs
Michael	Micheal
Michael's	Micheal's
Midas	amids	maids
Midland	midland
Midland's	midland's
Midway	midway
Mike	mike
Mike's	mike's
Miles	Selim	limes	miles	slime	smile
Mill	mill
Mill's	mill's
Miller	miller
Miller's	miller's
Millet	millet
Millet's	millet's
Mills	mills
Milo	limo
Milquetoast	milquetoast
Milton	Tomlin
Milton's	Tomlin's
Mingus	musing
Minnesota	nominates
Minoans	mansion
Minos	Simon
Minot	Timon
Minot's	Timon's
Minsk	minks
Mir	rim
Mir's	rim's
Miss	Sims	isms	miss
Misses	misses
Mister	merits	mister	miters	remits	timers
Mister's	mister's
Misty	misty
Mobil	limbo
Mobil's	limbo's
Mobile	mobile
Moll	moll
Moll's	moll's
Mona	Oman	moan
Mona's	Oman's	moan's
Monday	dynamo
Monday's	dynamo's
Mondays	dynamos
Monera	enamor
Monet	Monte
Monet's	Monte's
Monk	monk
Monk's	monk's
Monroe	Moreno
Monroe's	Moreno's
Moody	moody
Moon	mono	moon
Moon's	moon's
Moor	Moro	moor	room
Moor's	Moro's	moor's	room's
Moore	Romeo
Moore's	Romeo's
Moors	moors	rooms
Moran	Norma	Ramon	Roman	manor	roman
Moran's	Norma's	Ramon's	manor's
More	Rome	more
More's	Rome's
Morin	minor
Morocco	morocco
Morocco's	morocco's
Morrow	morrow
Morrow's	morrow's
Morse	Romes	mores
Mosaic	mosaic
Moses	moses
Moss	moss
Moss's	moss's
Mount	mount
Ms	Sm	ms
Mt	Tm
Mt's	Tm's
Munch	munch
Munro	mourn
Muscat	muscat
Muscat's	muscat's
Muse	emus	muse
Myrtle	myrtle	termly
Myrtle's	myrtle's
Na	an
Nagy	Yang
Nagy's	Yang's
Nahum	human
Nancy	canny
Napier	rapine
Napier's	rapine's
Naples	panels	planes
Napster	entraps	parents	pastern
Napster's	pastern's
Narcissus	narcissus
Narcissus's	narcissus's
Narmada	Ramadan
Narmada's	Ramadan's
Nashua	Shauna
Nashua's	Shauna's
Nassau	Susana	saunas
Nassau's	Susana's
Nasser	snares
Nat	ant	tan
Nat's	ant's	tan's
Nation	anoint	nation
Nationwide	nationwide
Nautilus	nautilus
Ned	den	end
Ned's	den's	end's
Negroid	eroding	ignored	redoing
Negros	goners
Neil	Nile	lien	line
Neil's	Nile's	lien's	line's
Nemesis	Siemens	nemesis
Nemesis's	Siemens's
Nepal	panel	penal	plane
Nepal's	panel's	plane's
Nereid	denier	reined
Nereid's	denier's
Nero	Reno
Nero's	Reno's
Neruda	unread
Nestle	nestle
Nestor	Sterno	tenors	tensor
Nestor's	tensor's
Nevis	veins	vines
Newton	newton
Newton's	newton's
Nexis	nixes
Nice	nice
Nick	nick
Nick's	nick's
Nickelodeon	nickelodeon
Nickelodeon's	nickelodeon's
Nieves	envies
Niger	reign
Niger's	reign's
Nightingale	nightingale
Nightingale's	nightingale's
Nirvana	nirvana
Nita	Tina	anti
Nita's	Tina's
Nobel	Noble	noble
Nobel's	Noble's
Noe	eon	one
Noe's	eon's
Noels	Olsen	noels
Nola	loan
Nola's	loan's
Nome	omen
Nome's	omen's
Nona	anon
Norse	snore
North	north	thorn
North's	north's	thorn's
Northeast	northeast
Northeast's	northeast's
Northerner	northerner
Norths	thorns
Northwest	northwest
Northwest's	northwest's
Noyes	nosey
Numbers	numbers
Occidental	occidental
Occidentals	occidentals
Ochoa	achoo
Oct	cot
Oct's	cot's
Oder	doer	redo	rode
Oder's	doer's
Odets	doest	dotes
Odom	doom	mood
Odom's	doom's	mood's
Odyssey	odyssey
Olaf	foal	loaf
Olaf's	foal's	loaf's
Olav	oval
Olga	gaol	goal
Olga's	gaol's	goal's
Olin	lion	loin
Olin's	lion's	loin's
Olive	olive	voile
Olive's	olive's	voile's
Olson	Solon	loons
Olson's	Solon's
Olympian	palimony
Omar	roam
Onsager	oranges
Ontario	oration
Ontario's	oration's
Oort	Root	root
Oort's	Root's	root's
Opel	Pole	lope	pole
Opel's	Pole's	pole's
Ora	oar
Ora's	oar's
Orestes	stereos
Orient	orient	tonier
Orient's	orient's
Oriental	oriental	relation
Orientals	orientals	relations
Orients	orients	stonier
Orin	iron
Orin's	iron's
Orlando	Rolando
Orlando's	Rolando's
Orleans	Salerno	loaners
Ortega	Tagore
Ortega's	Tagore's
Orval	valor
Orval's	valor's
Os	so
Osbert	sorbet	strobe
Osbert's	sorbet's	strobe's
Osborn	Robson
Osborn's	Robson's
Osborne	Robeson
Osborne's	Robeson's
Oscars	across
Oslo	solo
Oslo's	solo's
Otto	Toto	toot
Otto's	Toto's
Ottoman	ottoman
Ovid	void
Oxford	oxford
Oxford's	oxford's
Oxfords	oxfords
Pa	pa
Pa's	pa's
Pace	cape	pace
Pace's	cape's	pace's
Pacific	pacific
Page	gape	page
Page's	page's
Palau	Paula
Palestine	penalties
Palisades	palisades
Pam	amp	map
Pam's	amp's	map's
Pampers	pampers
Pan	nap	pan
Pansy	pansy
Pansy's	pansy's
Pantheon	pantheon
Pantheon's	pantheon's
Paradise	paradise
Paradise's	paradise's
Paramount	paramount
Paris	Parsi	pairs
Park	park
Park's	park's
Parks	parks	spark
Parliament	parliament
Parliament's	parliament's
Parliaments	parliaments	paternalism
Parsons	parsons
Passion	passion
Passion's	passion's
Passions	passions
Passover	overpass
Passover's	overpass's
Pasteur	pasture
Pasteur's	pasture's
Pat	apt	pat	tap
Pat's	tap's
Pate	pate	peat	tape
Pate's	pate's	peat's	tape's
Patel	leapt	petal	plate	pleat
Patel's	petal's	plate's	pleat's
Paterson	proteans
Patsy	pasty	patsy
Patsy's	patsy's
Patty	patty
Patty's	patty's
Peace	peace
Peace's	peace's
Pearl	paler	pearl
Pearl's	pearl's
Pearson	persona
Pearson's	persona's
Peary	payer	repay
Peary's	payer's
Pechora	poacher
Pechora's	poacher's
Peck	peck
Peck's	peck's
Pecos	copes	copse	scope
Pecos's	copse's	scope's
Pedro	pored	roped
Peel	Pele	peel
Peel's	Pele's
Peg	peg
Peg's	peg's
Pei	pie
Pena	nape	pane
Pena's	nape's	pane's
Penny	penny
Penny's	penny's
Pentagon	pentagon
Pentagon's	pentagon's
Pepsi	pipes
Perm	perm
Perm's	perm's
Pernod	ponder
Peron	prone
Perot	trope
Perot's	trope's
Perseid	preside
Perseus	peruses
Persia	aspire	praise	spirea
Persia's	praise's	spirea's
Peru	pure
Peter	peter
Peters	pester	peters	preset
Petersen	preteens	pretense
Petersen's	pretense's
Petra	apter	prate	taper
Petty	petty
Pharaoh	pharaoh
Pharaohs	pharaohs
Philistine	philistine
Philistines	philistines
Phoebe	phoebe
Phoebe's	phoebe's
Phoenix	phoenix
Phoenix's	phoenix's
Pierce	pierce	recipe
Pierce's	recipe's
Pigmies	pigmies
Pigmy	gimpy	pigmy
Pike	pike
Pike's	pike's
Pilgrim	pilgrim
Pilgrims	pilgrims
Pinochet	phonetic
Pippin	pippin
Pippin's	pippin's
Piraeus	upraise
Pisces	spices
Platonic	platonic
Playboy	playboy
Playboy's	playboy's
Pogo	goop
Pogo's	goop's
Poisson	poisons
Poles	lopes	poles	slope
Polish	polish
Polo	loop	polo	pool
Polo's	loop's	polo's	pool's
Pompadour	pompadour
Pompadour's	pompadour's
Pontiac	caption
Pontiac's	caption's
Pooh	hoop	pooh
Pooh's	hoop's
Pope	pope
Pope's	pope's
Popes	popes
Porsche	porches
Porter	porter	report
Porter's	porter's	report's
Poseidon	poisoned
Post	opts	post	pots	spot	stop	tops
Post's	post's	spot's
Potter	potter
Potter's	potter's
Pound	pound
Powers	powers
Praetorian	reparation
Pres	reps
Prescott	protects
President	president
Presidents	presidents
Price	price
Price's	price's
Prince	pincer	prince
Prince's	prince's
Prof	prof
Prohibition	prohibition
Prohibition's	prohibition's
Prohibitions	prohibitions
Protestant	protestant
Protestants	protestants
Proteus	posture	troupes
Proteus's	posture's
Proust	sprout	stupor
Proust's	stupor's
Proverbs	proverbs
Providence	providence
Providence's	providence's
Prudence	prudence
Prudence's	prudence's
Prudential	prudential
Psalms	psalms
Psalter	plaster	stapler
Psalter's	plaster's	stapler's
Psalters	plasters	staplers
Psyche	psyche
Psyche's	psyche's
Ptah	path
Ptah's	path's
Pu	up
Puck	puck
Puck's	puck's
Pueblo	pueblo
Pueblo's	pueblo's
Pueblos	pueblos
Puget	getup
Puget's	getup's
Punch	punch
Purims	purism
Puritan	puritan
Puritan's	puritan's
Puritanism	puritanism
Puritans	Rasputin	puritans
Purus	usurp
Putin	input
Putin's	input's
Pygmies	pygmies
Pygmy	pygmy
Pygmy's	pygmy's
Pyle	yelp
Python	python
Python's	python's
Queen	queen
Queen's	queen's
Queens	queens
Quisling	quisling
Quisling's	quisling's
Quito	quoit
Quito's	quoit's
RCA	arc	car
RCA's	arc's	car's
Rae	are	ear	era
Rae's	ear's	era's
Raffles	raffles
Rainier	rainier
Ramada	armada
Ramada's	armada's
Ramos	roams
Ramses	smears
Rand	darn
Randy	randy
Rather	rather
Raul	Ural
Raul's	Ural's
Ravel	ravel
Ray	ray
Ray's	ray's
Realtor	realtor
Realtors	realtors
Reba	bare	bear
Recife	fierce
Red	red
Reed	deer	reed
Reed's	deer's	reed's
Reeves	reeves	severe
Regina	regain
Regor	Roger	roger
Regor's	Roger's
Reid	Ride	dire	ired	ride
Remington	mentoring
Remus	serum
Remus's	serum's
Renaissance	renaissance
Renaissances	renaissances
Rep	per	rep
Rep's	rep's
Representative	representative
Representatives	representatives
Republican	republican
Republicans	republicans
Resurrection	resurrection
Resurrection's	resurrection's
Resurrections	resurrections
Reunion	reunion
Rev	rev
Rev's	rev's
Reva	Vera	aver	rave
Reva's	Vera's
Revelations	revelations
Revere	revere
Reverend	reverend
Reyna	yearn
Rhee	here
Rhee's	here's
Rhoda	hoard
Rhoda's	hoard's
Rhodes	hordes	horsed	shored
Rich	rich
Rick	rick
Rick's	rick's
Rickie	ickier
Riddle	riddle
Riddle's	riddle's
Riel	lire	rile
Rilke	liker
Ringo	groin
Ringo's	groin's
Ripley	ripely
Rivera	arrive
Rivers	rivers
Riverside	riverside
Roach	Rocha	roach
Roach's	Rocha's	roach's
Rob	orb	rob
Rob's	orb's
Robbin	ribbon
Robbin's	ribbon's
Robbins	ribbons
Robin	robin
Robin's	robin's
Roche	chore	ocher	ochre
Roche's	chore's	ocher's
Rockne	reckon
Rocky	rocky
Rod	rod
Rod's	rod's
Rodney	yonder
Roentgen	roentgen
Roentgen's	roentgen's
Rogers	rogers
Romanies	moraines
Romano	maroon
Romans	manors	ransom
Romans's	ransom's
Romanticism	romanticism
Romeos	morose
Romero	roomer
Romero's	roomer's
Ron	nor
Rosa	oars	soar
Rosalind	ordinals
Rosanne	Roseann
Rosanne's	Roseann's
Roseau	arouse
Rosemary	rosemary
Rosemary's	rosemary's
Rosetta	rotates	toaster
Rosetta's	toaster's
Rosie	osier
Rosie's	osier's
Roth	Thor
Roth's	Thor's
Rover	rover
Rover's	rover's
Rowe	wore
Royal	royal
Ru	Ur
Ru's	Ur's
Rubin	bruin
Rubin's	bruin's
Ruby	bury	ruby
Ruby's	ruby's
Rush	rush
Russo	sours
Rusty	rusty
Ruth	Thur	hurt	thru
Ruth's	Thur's
Ryan	nary	yarn
Ryan's	yarn's
Ryder	dryer
Ryder's	dryer's
Saab	baas
Saar	Sara
Saar's	Sara's
Sabin	basin
Sabin's	basin's
Sabre	bares	baser	bears	saber	sabre
Sabre's	saber's
Sadie	aides	aside	ideas
Sahel	hales	heals	leash	shale
Sakha	Shaka
Sakha's	Shaka's
Saks	asks
Salamis	salamis
Salem	Selma	lames	males	meals
Salem's	Selma's
Salinger	slangier
Sallie	allies
Sallie's	allies's
Sally	sally
Sally's	sally's
Sam	mas
Samoyed	someday
Sancho	nachos
Sand	ands	sand
Sand's	sand's
Sanders	sanders
Sandy	sandy
Sang	nags	sang	snag
Sang's	snag's
Sanger	angers	ranges
Santa	Satan
Santa's	Satan's
Sapporo	apropos
Sargent	garnets	strange
Sargon	groans	organs	sarong
Sargon's	sarong's
Sarnoff	saffron
Sarnoff's	saffron's
Sartre	arrest	rarest	raster
Sartre's	raster's
Satanism	mantissa	satanism
Satanism's	mantissa's
Savage	savage
Savannah	savannah
Savior	savior
Savior's	savior's
Sawyer	sawyer
Sawyer's	sawyer's
Saxon	axons
Sc's	cs's
Scheat	chaste	cheats	sachet
Scheat's	sachet's
Schedar	crashed
Schick	chicks
Schiller	chillers
Schnabel	blanches
Schnauzer	schnauzer
Schnauzer's	schnauzer's
Schubert	butchers
Scopes	copses	scopes
Scot	cost	cots
Scot's	cost's
Scotch	scotch
Scotches	scotches
Scots	costs
Scrabble	scrabble
Scripture	scripture
Scripture's	scripture's
Scriptures	scriptures
Scrooge	scrooge
Scud	cuds	scud
Sean	sane
Sears	sears
Secretariat	secretariat
Secretariat's	secretariat's
Secretaries	secretaries
Secretary	secretary
Seder	deers	deres	reeds	sered
Sega	ages	sage
Sega's	sage's
Segre	serge
Segre's	serge's
Selim's	slime's	smile's
Sellers	resells	sellers
Semarang	managers
Senate	sateen	senate
Senate's	sateen's	senate's
Senates	senates
Senator	senator	treason
Seneca	encase
Senecas	encases
Senior	nosier	senior
Seniors	seniors
Seoul	louse
Seoul's	louse's
Sepoy	poesy
Sepoy's	poesy's
Sept	pest	pets	step
Sept's	pest's	step's
Serbia	braise	rabies
Sergio	orgies
Serpens	Spenser
Serpens's	Spenser's
Serra	rares	rears
Set	set
Seton	Stone	notes	onset	stone	tones
Seton's	Stone's	onset's	stone's
Severn	nerves
Seward	waders
Sexton	sexton
Sexton's	sexton's
Shane	ashen
Shanghai	shanghai
Shantung	shantung
Shantung's	shantung's
Shari	hairs
Sharp	harps	sharp
Sharpe	Sherpa	phrase	seraph
Sharpe's	Sherpa's	phrase's	seraph's
Shaw	Wash	haws	wash
Shaw's	Wash's
Sheol	holes
Shepard	phrased	sharped
Shepherd	shepherd
Shepherd's	shepherd's
Sheri	heirs	hires	shire
Sheri's	shire's
Sherpas	phrases	seraphs
Sherrie	rehires
Sherry	sherry
Sherry's	sherry's
Shetland	Stendhal
Shields	shields
Short	short
Shorthorn	shorthorn
Shorthorn's	shorthorn's
Shula	hauls	hulas
Si	is
Siam	aims
Siberian	binaries
Sibyl	Sybil	sibyl
Sibyl's	Sybil's	sibyl's
Sid's	dis's
Silas	sails	sisal
Silas's	sisal's
Silva	vials
Simone	monies
Simone's	monies's
Sinatra	artisan	tsarina
Sinatra's	artisan's	tsarina's
Sindbad	disband
Singleton	singleton
Singleton's	singleton's
Sister	resist	sister
Sisters	resists	sisters
Siva's	Visa's	visa's
Skye	keys
Slater	alerts	alters	salter	staler
Slavic	Vlasic	cavils
Slavic's	Vlasic's
Slinky	slinky
Sloan	loans	salon
Sloan's	salon's
Slurpee	repulse
Small	malls	small
Smith	smith
Smith's	smith's
Smuts	musts	smuts
Snake	snake	sneak
Snead's	sedan's
Snickers	snickers
Snider	diners	rinsed	snider
Snoopy	snoopy
Snow	owns	snow	sown
Snow's	snow's
Socrates	coarsest	coasters
Socratic	acrostic
Sodom	dooms	moods
Soho	ohos	shoo
Sol	sol
Sol's	sol's
Solis	silos	soils
Somme	memos
Son	son
Son's	son's
Sondheim	hedonism
Sondheim's	hedonism's
Sondra	adorns
Sonny	sonny
Sonny's	sonny's
Sontag	tangos
Sony	nosy
Sony's	nosy's
Soto	soot
Soto's	soot's
South	shout	south	thous
South's	shout's	south's
Southeast	southeast
Southeast's	southeast's
Southerner	southerner
Southerner's	southerner's
Southerners	southerners
Souths	shouts
Southwest	southwest
Southwest's	southwest's
Soviet	soviet
Soviets	soviets
Spain	pains
Spam	amps	maps
Sparks	sparks
Sparta	satrap
Sparta's	satrap's
Spartan	spartan
Spears	parses	passer	spares	sparse	spears
Sperry	spryer
Sphinx	sphinx
Sphinx's	sphinx's
Spica	aspic
Spica's	aspic's
Spock	pocks
Sprint	prints	sprint
Sprint's	sprint's
Sprite	priest	ripest	sprite	stripe
Sprite's	priest's	sprite's	stripe's
Sr	rs
Srinagar	arraigns
St	ts
Stael	Tesla	least	slate	stale	steal	tales	teals
Stael's	Tesla's	slate's
Stan	ants	tans
Staples	pastels	staples
Stark	stark
Starkey	streaky
Stefan	fasten
Stein	Stine	inset	stein	tines
Stein's	Stine's	stein's
Steiner	entries
Stengel	gentles
Sterling	ringlets	sterling
Sterling's	sterling's
Steuben	subteen
Steuben's	subteen's
Steven	events
Stewart	swatter
Stewart's	swatter's
Stieglitz	glitziest
Stoic	stoic
Stoic's	stoic's
Stoicism	stoicism
Stoicism's	stoicism's
Stokes	stokes
Stokes's	stokes's
Stout	stout	touts
Strabo	aborts
Streisand	tardiness
Strong	strong
Stygian	staying
Suarez	azures
Sucre	cures	curse
Sucre's	curse's
Sue	sue	use
Suez	Zeus
Suez's	Zeus's
Suharto	authors
Sumatra	traumas
Sumerian	Suriname	aneurism
Summer	summer
Summer's	summer's
Summers	summers
Sumter	muster
Sun	sun
Sunbeam	sunbeam
Sunbeam's	sunbeam's
Sung	gnus	guns	snug	sung
Superior	superior
Superman	superman
Superman's	superman's
Susie	issue
Susie's	issue's
Svengali	leavings
Swede	sewed	weeds
Sweden	newsed
Swedish	swished
Sweet	sweet	weest
Swift	swift
Szilard	lizards
Tabitha	habitat
Tabitha's	habitat's
Tad	tad
Tad's	tad's
Taliesin	litanies
Talley	lately
Tangiers	angriest	gantries	ingrates	rangiest
Tanner	tanner
Tanner's	tanner's
Tao	oat
Tao's	oat's
Target	target
Target's	target's
Tartar	tartar
Tartar's	tartar's
Tartars	tartars
Tatar	attar
Tatar's	attar's
Tatars	strata
Teheran	earthen	hearten
Tehran	anther
Teletype	teletype
Teletypes	teletypes
Tell	tell
Teller	retell	teller
Teller's	teller's
Templar	trample
Teri	rite	tier	tire
Teri's	rite's	tier's	tire's
Terran	errant	ranter
Terran's	ranter's
Terrance	recreant
Terrence	recenter
Terrie	retire
Terry	retry	terry
Terry's	terry's
Tertiary	tertiary
Tess	sets
Tessa's	asset's
Texas	taxes
Thais	Tisha	saith
Thales	halest	lathes
Thanksgiving	thanksgiving
Thanksgivings	thanksgivings
Thatcher	thatcher
Thea	hate	heat
Thea's	heat's
Thebes	behest
Theosophy	theosophy
Theresa	heaters	reheats
Thermos	mothers	smother	thermos
Thermoses	thermoses
Theron	hornet	throne
Theron's	hornet's	throne's
Thespian	thespian
Thoroughbred	thoroughbred
Ti's	it's	ti's
Tiber	tribe
Tiber's	tribe's
Tide	diet	edit	tide	tied
Tide's	diet's
Tientsin	tinniest
Ting	ting
Titan	taint	titan
Titan's	titan's
Titanic	titanic
Titus	Tutsi
Tlingit	tilting	titling
Toledo	looted	tooled
Tolyatti	totality
Tolyatti's	totality's
Tom	tom
Tom's	tom's
Tomas	atoms	moats
Tonga	tango
Tonga's	tango's
Toni	into
Tony	tony
Topsy	typos
Tories	sortie
Torres	resort	roster	sorter
Tory	Troy	troy	tyro
Tory's	Troy's	tyro's
Tosca	ascot	coast	coats	tacos
Tosca's	ascot's	coast's
Townes	Weston
Tran	rant
Trey	Tyre
Trey's	Tyre's
Trident	trident
Trident's	trident's
Trieste	testier
Trina	train
Trinities	trinities
Trinity	trinity
Trinity's	trinity's
Trippe	tipper
Trippe's	tipper's
Tristan	transit
Tristan's	transit's
Troyes	oyster	storey	tyroes
Trump	trump
Trump's	trump's
Truth	truth
Tsingtao	toasting
Tucker	tucker
Tucker's	tucker's
Tucson	Tuscon	counts
Tucson's	Tuscon's
Tues	suet
Tums	must	smut
Tums's	smut's
Tunis	units
Turing	truing
Turkey	turkey
Turkey's	turkey's
Turner	return	turner
Turner's	turner's
Turpin	turnip
Turpin's	turnip's
Tutu	tutu
Tutu's	tutu's
Twain	twain
Tweed	tweed
Tweed's	tweed's
Tyson	stony
Ulster	luster	result	rustle
Ulster's	luster's	result's
Unions	unions	unison
Urban	unbar	urban
Utopia	utopia
Utopian	utopian
Utopians	utopians
Utopias	utopias
Vader	raved
Valarie	Valeria
Valarie's	Valeria's
Valentine	valentine
Valentine's	valentine's
Valois	violas
Van	van
Van's	van's
Vandal	vandal
Vandal's	vandal's
Varese	averse
Vedas	saved
Vega	gave
Velcro	clover
Velcro's	clover's
Velcros	clovers
Venice	evince
Verdi	diver	drive
Verdi's	diver's
Verna	raven
Verna's	raven's
Verne	nerve	never
Verne's	nerve's
Veronese	overseen
Vesta	stave
Vesta's	stave's
Victor	victor
Victor's	victor's
Vietcong	coveting
Vila	vial
Villa	villa
Villa's	villa's
Viola	viola
Viola's	viola's
Violet	violet
Violet's	violet's
Virgo	vigor
Virgo's	vigor's
Vogue	vogue
Vogue's	vogue's
Voyager	voyager
Voyager's	voyager's
Wac	caw
Wacs	caws
Wade	awed	wade
Wake	wake	weak
Wake's	wake's
Wales	wales	weals
Walker	walker
Walker's	walker's
Wall	wall
Wall's	wall's
Walls	walls
Walsh	shawl
Walsh's	shawl's
Walters	wastrel
Wang	gnaw
Ward	draw	ward
Ward's	ward's
Ware	ware	wear
Ware's	ware's
Warner	Warren	warren
Warner's	Warren's	warren's
Wasp	paws	swap	wasp
Wasp's	wasp's
Wasps	swaps	wasps
Waterford	afterword
Waterford's	afterword's
Waters	rawest	waster	waters
Watt	watt
Watt's	watt's
Watts	watts
Weaver	weaver
Weaver's	weaver's
Wed	dew	wed
Wed's	dew's
Weddell	dwelled
Weeks	weeks
Weiss	wises
Wellington	wellington
Wells	swell	wells
Welsh	welsh
Wesak	askew	wakes
West	stew	west	wets
West's	stew's	west's
Western	western
Westerner	westerner
Westerners	westerners
Westerns	westerns
Wests	stews	wests
Wheeler	wheeler
Wheeler's	wheeler's
Wheeling	wheeling
Wheeling's	wheeling's
Whirlpool	whirlpool
Whirlpool's	whirlpool's
Whistler	whistler
Whistler's	whistler's
White	white	withe
Whites	whites	withes
Wigner	winger
Wigner's	winger's
Wilde	wield	wiled
Wilder	wilder
Wiley	Wylie
Wiley's	Wylie's
Will	will
Windbreaker	windbreaker
Windows	windows
Windward	windward
Winkle	welkin
Winkle's	welkin's
Winters	winters
Wise	wise
Witt	twit
Wolf	flow	fowl	wolf
Wolf's	fowl's	wolf's
Wonder	downer	wonder
Wonder's	downer's	wonder's
Wong	gown
Wong's	gown's
Wood	wood
Wood's	wood's
Woods	woods
Workman	workman
Workman's	workman's
Worms	worms
Wren	wren
Wren's	wren's
Wright	wright
Wright's	wright's
Xe	ex
Yank	yank
Yanks	snaky	yanks
Yates	Yeats	yeast
Yb	by
Yeats's	yeast's
Yemen	enemy
Yemen's	enemy's
Young	young
Ypres	preys	pyres
Yule	yule
Yule's	yule's
Yuletide	yuletide
Zeno	zone
Zeno's	zone's
Zeppelin	zeppelin
Zeppelin's	zeppelin's
Zest	zest
Zest's	zest's
abeam	ameba
abed	bade	bead
abet	bate	beat	beta
abhorred	harbored
abhorring	harboring
abides	biased
abler	blare
ablest	bleats	stable	tables
abode	adobe
abode's	adobe's
abodes	adobes
abridge	brigade
abridges	brigades
abuse	beaus
abuts	tubas
accouterments	accoutrements
accrual	caracul
accrual's	caracul's
accrues	accuser
ache	each
acne	cane
acne's	cane's
aconites	canoeist
acre	care	race
acre's	race's
acrider	carried
act	cat
act's	cat's
acted	cadet
action	cation
action's	cation's
actions	cations
actress	casters	recasts
actuator	autocrat
actuator's	autocrat's
actuators	autocrats
acuter	curate
add	dad
adder	dared	dread
adders	dreads	sadder
addle	laded
addles	saddle
adds	dads
adept	taped
adepter	predate	tapered
adepts	pasted
adhere	header
adhered	redhead
adheres	headers	hearsed	sheared
adjuster	readjust
adjusters	readjusts
admirer	married
admirers	marrieds
admires	misread	sidearm
admits	amidst
admonition	domination
admonition's	domination's
adore	oared
adores	soared
adroitly	dilatory	idolatry
ads	sad
advances	canvased
adverb	braved
adverts	starved
adze	daze
adzes	dazes
aeries	easier
aery	year
affair	raffia
affair's	raffia's
afield	failed
aft	fat
afters	faster	strafe
afterwords	forwardest
ageism	images
agnostic	coasting	coatings
agree	eager
agreed	geared
agrees	grease
ah	ha
ahems	shame
aide	idea
aide's	idea's
aids	dais	said
ailments	manliest
airings	arising	raising
airs	sari
aisled	ideals	ladies	sailed
aisling	sailing
ajar	raja
alarming	marginal
alarmingly	marginally
alb	lab
alb's	lab's
albs	labs	slab
alcove	coeval
alcoves	coevals
alert	alter	later
alerted	altered	related	treadle
alerting	altering	integral	relating	triangle
alga	gala
alga's	gala's
algorithm	logarithm
algorithm's	logarithm's
algorithmic	logarithmic
algorithms	logarithms
aliens	saline
aligned	dealing	leading
alignment	lamenting
aligns	signal
alit	tail
allergies	galleries
allergy	gallery	largely	regally
allergy's	gallery's
allot	atoll
allots	atolls
allotted	totalled
allotting	totalling
allover	overall
allows	sallow
alloy	loyal
allures	laurels
alms	lams	slam
aloft	float
alpines	spaniel
altars	astral
altitude	latitude
altitude's	latitude's
altitudes	latitudes
altruism	muralist
altruism's	muralist's
alum	maul
alumna	manual
alums	mauls
ambled	bedlam	blamed	lambed
ambles	blames
ambling	blaming	lambing
amen	mane	mean	name
amened	demean
amening	meaning
amenity	anytime
amid	maid
among	mango
amortize	atomizer
amortizes	atomizers
amphitheater	amphitheatre
amphitheaters	amphitheatres
ample	maple
amply	palmy
amuses	assume
anapest	peasant
anapest's	peasant's
anapests	peasants
ancestries	resistance
ancienter	nectarine
ancients	canniest	instance
anemic	cinema
anew	wane	wean
angels	angles	gleans
anger	range
anger's	range's
angered	derange	enraged	grandee	grenade
angering	enraging
angrier	earring	rangier	rearing
angry	rangy
angst	gnats	tangs
ankhs	hanks	khans	shank
anklets	lankest
annoyed	anodyne
annuities	insinuate
anoints	nations
answers	rawness
antagonist	stagnation
antagonist's	stagnation's
anteing	antigen	gentian
anthologies	theologians
antidotes	stationed
antigen's	gentian's
antigens	gentians
antiparticles	paternalistic
antis	saint	satin	stain
antler	learnt	rental
antler's	rental's
antlers	rentals
any	nay
ape	pea
ape's	pea's
apes	apse	peas
aplenty	penalty
appal	papal
appealing	lagniappe
append	napped
appends	snapped
appraised	disappear
apprise	sappier
aprons	parson
arced	cadre	cared	cedar	raced
arch	char
archaism	charisma
archaism's	charisma's
arches	chaser	search
archest	chaster
arching	chagrin
arcing	caring	racing
arcked	racked
arcking	racking
arcs	cars	scar
ardent	ranted
argon	groan	organ
argon's	groan's	organ's
argue	auger
argues	augers
arid	raid
arider	raider
aridest	astride	staider	tardies	tirades
arises	raises
armed	dream
armfuls	armsful
armpit	impart
armpits	imparts
armrest	smarter
arrested	retreads	serrated
arrogant	tarragon
arson	roans	sonar
arson's	sonar's
article	recital
article's	recital's
articles	recitals
artier	irater
artiest	artiste	attires	iratest	tastier
artisans	tsarinas
artist	strait	traits
artist's	strait's
artistes	artsiest
artists	straits
arts	rats	star	tars	tsar
artsier	tarries
artsy	satyr	stray	trays
arty	tray
ascend	dances
ascent	enacts	stance
ascent's	stance's
ascents	stances
ascertains	sectarians
ascots	coasts
ascribed	carbides
ash	has
ashore	hoarse
asides	daises
asleep	elapse	please
asp	pas	sap	spa
asp's	sap's	spa's
aspirant	partisan
aspirant's	partisan's
aspirants	partisans
aspirate	parasite
aspirated	disparate
aspirates	parasites
aspired	despair	diapers	praised
aspires	praises	spireas
aspiring	praising
asps	pass	saps	spas
assaying	gainsays
assent	sanest
assert	asters	stares
assess	sasses
assigns	sassing
assort	roasts
assorting	organists
assuage	sausage
assuages	sausages
aster	rates	stare	tares	tears
astern	sterna
astir	sitar	stair
astute	statue
astuter	stature
astutest	statutes
ate	eat	eta	tea
ateliers	earliest
atheists	hastiest
atom	moat
atom's	moat's
atoned	donate
attentive	tentative
attentively	tentatively
attics	static
attuned	taunted
attunes	tetanus
attuning	taunting
auction	caution
auction's	caution's
auctioned	cautioned	education
auctioning	cautioning
auctions	cautions
aunt	tuna
aunt's	tuna's
aunts	tunas
austerer	treasure
avails	saliva
avarice	caviare
avenger	engrave
avengers	engraves
avers	raves	saver
averts	starve	vaster
avid	diva
avider	varied
avidest	datives	vistaed
awl	law
awl's	law's
awls	laws	slaw
awning	waning
awry	wary
axles	laxes
ay	ya
aye	yea
ayes	easy	yeas
babbled	blabbed
babbling	blabbing
babiest	tabbies
backrest	brackets
backward	drawback
backwards	drawbacks
bacterial	calibrate
bad	dab
badger	barged	garbed
bag	gab
bagels	gables
bags	gabs
bahs	bash
bake	beak
bakers	brakes	breaks
bakes	beaks
balded	bladed
baldest	blasted	stabled
balding	blading
baled	blade
baleen	enable
balms	lambs
balsa	basal
ban	nab
banalities	insatiable
banes	beans
bans	nabs
bantams	batsman
bar	bra
bar's	bra's
bards	brads	drabs
barely	barley	bleary
barest	breast
bargained	gabardine
barging	garbing
barked	braked	debark
barking	braking
bars	bras
based	beads
basely	belays
basest	bastes	beasts
basis	bassi
bast	bats	stab	tabs
bastion	obtains
basts	stabs
bat	tab
bat's	tab's
bathers	breaths
battier	biretta
battles	tablets
baud	daub
bauds	daubs
bayed	beady
beadiest	diabetes
bearded	breaded
bearding	breading
beards	breads	debars
beastlier	bleariest	liberates
beater	berate	rebate
beater's	rebate's
beaters	berates	rebates
beavered	bereaved
beavering	bereaving
bed	deb
bed's	deb's
bedder	breded
bedroom	boredom
bedroom's	boredom's
bedsore	sobered
beeches	beseech
beefier	freebie
beets	beset
begins	beings	binges
begrudge	debugger
begrudges	debuggers
belated	bleated
belied	edible
bellied	libeled
below	bowel	elbow
belows	bowels	elbows
belts	blest
berated	debater	rebated
berating	rebating
berthing	brighten
besoms	emboss
bestiary	sybarite
bestiary's	sybarite's
bestir	tribes
betided	debited
betiding	debiting
bidder	birded
bidet	debit
bidet's	debit's
bidets	debits
bin	nib
bin's	nib's
binary	brainy
binder	inbred	rebind
binders	inbreds	rebinds
bins	nibs
bipedal	piebald
bipolar	parboil
bistro	orbits
bizarre	brazier
bizarres	braziers
blades	sabled
blamer	marble	ramble
blankest	blankets
blaster	stabler
blasting	stabling
blearily	reliably
bleat	table
bleating	tangible
blessing	glibness
blessing's	glibness's
blissing	siblings
blister	bristle
blister's	bristle's
blisters	bristles
blobbed	bobbled
blobbing	bobbling
blot	bolt
blot's	bolt's
blots	bolts
blotted	bottled
blotting	bottling
bloused	doubles
blow	bowl
blower	bowler
blower's	bowler's
blowers	bowlers
blowing	bowling
blowing's	bowling's
blows	bowls
blue	lube
blue's	lube's
blued	lubed
bluer	ruble
blues	lubes
bluest	bustle	sublet	subtle
bluing	lubing
blushes	bushels
bluster	butlers	subtler
board	broad
boarded	roadbed
boarder	broader
boards	broads
boast	boats
boaster	boaters
bog	gob
bog's	gob's
bogeyman	moneybag
bogs	gobs
bole	lobe
bole's	lobe's
boles	lobes
bolster	lobster
bolstered	lobstered
bolstering	lobstering
bolsters	lobsters
bombed	mobbed
bombing	mobbing
boner	borne
bonus	bosun
bonus's	bosun's
booms	bosom
boost	boots
bordello	doorbell
bordello's	doorbell's
bordellos	doorbells
bored	robed
boring	robing
bosh	hobs
boss	sobs
bosser	sobers
bosses	obsess
bouldered	redoubled
bouldering	redoubling
bounder	rebound
bounders	rebounds	suborned
bowel's	elbow's
brag	garb	grab
brags	garbs	grabs
braids	disbar
braised	seabird	sidebar
brawled	warbled
brawler	warbler
brawler's	warbler's
brawlers	warblers
brawling	warbling
breasted	debaters
bredes	breeds
bribed	ribbed
bribing	ribbing
bridal	ribald
brides	debris
brief	fiber
briefed	debrief
briefs	fibers
briskest	briskets
bristled	driblets
broadcaster	rebroadcast
broadcaster's	rebroadcast's
broadcasters	rebroadcasts
broadside	sideboard
broadside's	sideboard's
broadsides	sideboards
broth	throb
broths	throbs
bruise	buries	busier	rubies
brunt	burnt
brush	shrub
brush's	shrub's
brute	rebut	tuber
brute's	tuber's
brutes	buster	rebuts	tubers
budge	debug
budges	debugs
buds	dubs
buffer	rebuff
buffered	rebuffed
buffering	rebuffing
buffers	rebuffs
bugle	bulge
bugle's	bulge's
bugled	bulged
bugler	burgle
buglers	burgles
bugles	bulges
bugling	bulging
builder	rebuild
builders	rebuilds
bun	nub
bun's	nub's
bunked	debunk
buns	nubs	snub
bur	rub
burble	lubber	rubble
burbled	rubbled
burbles	lubbers	rubbles
burbling	rubbling
burden	burned
burg	grub
burgs	grubs
buried	rubied
burs	rubs
burying	rubying
bus	sub
bus's	sub's
buss	subs
bust	buts	stub	tubs
bust's	stub's
busted	debuts
bustles	sublets
busts	stubs
busy	buys
buttered	rebutted
buttering	rebutting
cabs	scab
cachets	catches
cackled	clacked
cackling	clacking
cadets	casted
cadge	caged
cadger	graced
cadre's	cedar's
cadres	cedars	sacred	scared
cads	scad
caduceus	caucused
caisson	casinos
caliper	replica
caliper's	replica's
calipers	replicas
calk	lack
calked	lacked
calking	lacking
calks	lacks	slack
caller	cellar	recall
caller's	cellar's
callers	cellars	recalls
calligraphy	graphically
calm	clam
calms	clams
calumnies	masculine
cambered	embraced
cambering	embracing
camels	mescal
cameo	comae
camped	decamp
campers	scamper
campiest	campsite
camps	scamp
cams	scam
candider	riddance
candidest	distanced
candle	lanced
caned	dance
canister	scantier
canoe	ocean
canoe's	ocean's
canoed	deacon
canoeists	cessation
canoes	oceans
canopying	poignancy
cans	scan
canted	decant
canter's	nectar's	trance's
cantered	decanter	recanted
cantering	recanting
canters	recants	scanter	trances
cantors	cartons
cants	scant
caped	paced
caper	crape	recap
caper's	crape's
capers	crapes	parsec	recaps	scrape
capes	paces	space
capstan	catnaps
capsule	upscale
caress	scares
caret	cater	crate	react	recta	trace
caret's	crate's	trace's
carets	caster	caters	crates	reacts	recast	traces
cargoes	corsage
caroled	oracled
caroling	oracling
carolled	collared
carolling	collaring
carp	crap
carp's	crap's
carped	redcap
carpel	parcel	placer
carpel's	parcel's	placer's
carpels	parcels	placers	scalper
carpets	spectra
carps	craps	scrap
carries	scarier
carted	crated	traced
cartel	claret	rectal
cartel's	claret's
cartels	clarets	scarlet
carting	crating	tracing
carve	crave
carved	craved
carves	craves
carving	craving
carving's	craving's
carvings	cravings
cashed	chased
cashes	chases
cashing	chasing
cask	sack
cask's	sack's
casks	sacks
casserole	escaroles
caste	taces
castle	cleats
castors	costars
casts	scats
casual	causal
casually	causally
casuals	causals
catalogue	coagulate
catalogued	coagulated
catalogues	coagulates
cataloguing	coagulating
catechism	schematic
catechisms	schematics
catered	created	reacted
caterer	retrace	terrace
caterer's	terrace's
caterers	retraces	terraces
catering	creating	reacting
caterings	recasting
cattily	tacitly
cattiness	scantiest	tacitness
cattiness's	tacitness's
cause	sauce
cause's	sauce's
caused	sauced
causes	sauces
causing	saucing
cavaliers	cavalries
caveat	vacate
caveats	vacates
cavern	craven
caverns	cravens
censer	screen
censer's	screen's
censers	screens
censor	crones
censored	encoders
center	recent
centered	decenter
centigram	cremating
cents	scent
certifiable	rectifiable
certification	rectification
certification's	rectification's
certifications	rectifications
certified	rectified
certifies	rectifies
certify	rectify
certifying	rectifying
certitude	rectitude
certitude's	rectitude's
cervices	crevices
cesium	miscue
cesium's	miscue's
chagrins	crashing
chalets	latches	satchel
chanters	stancher
chants	snatch	stanch
chapt	patch
charmed	marched
charmer	marcher
charmer's	marcher's
charmers	marchers
charming	marching
chars	crash
charts	starch
chasers	crashes
chastens	snatches	stanches
chatter	ratchet
chattered	ratcheted
chattering	ratcheting
chatters	ratchets
cheap	peach
cheat	teach
cheater	hectare	teacher
cheater's	hectare's	teacher's
cheaters	hectares	teachers
cheating	teaching
checker	recheck
checker's	recheck's
checkered	rechecked
checkering	rechecking
checkers	rechecks
cheeps	speech
chest	techs
chicest	hectics
chief	fiche
chief's	fiche's
chiefs	fiches
chiles	chisel
chin	inch
chit	itch
chit's	itch's
choked	hocked
chokers	shocker
choking	hocking
cholera	chorale
cholera's	chorale's
chorals	scholar
chose	echos
chum	much
churl	lurch
cider	cried	riced
cilantro	contrail
cinders	discern	rescind
ciphered	decipher
circle	cleric
circle's	cleric's
circles	clerics
cistern	cretins
citadel	dialect
citadel's	dialect's
citadels	dialects
cited	edict
cities	iciest
citric	critic
citruses	crusties	curtsies
civet	evict
civets	evicts
claimed	decimal	declaim	maliced	medical
claiming	malicing
clambers	scramble
clanged	glanced
clanging	glancing
claps	clasp	scalp
clareted	treacled
clareting	treacling
clasp's	scalp's
clasped	scalped
clasping	scalping
clasps	scalps
cleaners	cleanser
cleanings	cleansing
cleans	lances
cleanse	scalene
cleansers	clearness
cleared	declare
clearest	treacles
clefted	deflect
clematis	climates
clematises	timescales
clients	stencil
climaxes	exclaims
clinker	crinkle
clinkers	crinkles
clipper	cripple
clipper's	cripple's
clippers	cripples
clobber	cobbler
clobbers	cobblers
clod	cold
clodded	coddled
clodding	coddling
clods	colds	scold
cloister	costlier
closest	closets
clots	colts
cloud	could
clouts	locust
coal	cola
coal's	cola's
coals	colas
coarsen	corneas
coastline	sectional
coastlines	sectionals
cocaine	oceanic
cockily	colicky
cod	doc
cod's	doc's
coddles	scolded
code	coed
code's	coed's
codes	coeds
cods	docs
coexist	exotics
cognition	incognito
coif	foci
coif's	foci's
coiled	docile
coin	icon
coin's	icon's
coins	icons	scion	sonic
colitis	solicit
collapsed	scalloped
collapsing	scalloping
collide	collied
colonialist	oscillation
colonialist's	oscillation's
colonialists	oscillations
comedian	demoniac
comics	cosmic
commissioned	decommission
compile	polemic
compiled	complied
compiles	complies	polemics
complaint	compliant
compressed	decompress
concerted	concreted
concerting	concreting
conciser	cornices
conditioner	recondition
conditioners	reconditions
condoles	consoled
condor	cordon
condor's	cordon's
condors	cordons
conduits	discount
cone	once
cones	scone
configures	refocusing
conical	laconic
conifers	forensic
conservation	conversation
conservation's	conversation's
conserve	converse
conserved	conversed
conserves	converses
conserving	conversing
considerate	desecration
consigned	seconding
consist	tocsins
consoles	coolness
consolidates	disconsolate
construe	counters	recounts	trounces
contains	sanction
contenting	contingent
continued	unnoticed
contuses	countess
coolest	ocelots
coops	scoop
coordinate	decoration
coordinates	decorations
coots	scoot
copings	copsing	scoping
copsed	scoped
copula	cupola
copula's	cupola's
copulas	cupolas
cords	scrod
cored	credo	decor
cores	score
corked	rocked
corking	rocking
corks	rocks
corns	scorn
corny	crony
corona	racoon
coroner	crooner
coroner's	crooner's
coroners	crooners
corps	crops
corpses	process
corpus	croups
corset's	escort's	sector's
corseted	escorted
corseting	escorting
corsets	escorts	sectors
coteries	esoteric
counter	recount	trounce
countered	recounted
countering	recounting
countries	cretinous	neurotics
coursed	scoured	sourced
coursing	scouring	sourcing
courteous	outsource
covert	vector
coverts	vectors
cowers	escrow
cowls	scowl
cows	scow
crams	scram
craned	dancer	narced
craning	narcing
crass	scars
cratered	retraced	terraced
cratering	retracing	terracing
craters	tracers
crawls	scrawl
creams	scream
creations	reactions
creative	reactive
creators	reactors
credential	interlaced
credit	direct
credited	directed
crediting	directing
creditor	director
creditor's	director's
creditors	directors
credits	directs
credos	decors	scored
creep	crepe
creeps	crepes
crews	screw
cries	rices
crimps	scrimp
crimson	microns
crisp	scrip
crisps	scrips
critters	restrict	stricter
crochets	crotches
crocus	occurs	succor
crocus's	succor's
crosser	scorers
crouped	produce
crud	curd
crud's	curd's
crude	cured
cruder	curred
crudest	crusted
crudities	diuretics
cruel	lucre	ulcer
cruelest	lectures
cruels	ulcers
cruelty	cutlery
cruelty's	cutlery's
cruet	cuter	truce
cruet's	truce's
cruiser	curries
cruisers	scurries
crumpets	spectrum
crust	curst
crustier	recruits
crusty	curtsy
cubist	cubits
cuffs	scuff
culls	scull
cums	scum
cupfuls	cupsful
cups	cusp
curbs	scrub
curdle	curled
cure	ecru
curer	recur
curtest	cutters
curtness	encrusts
cutlets	scuttle
dabbles	slabbed
daemon	moaned
dafter	farted	rafted
dagger	ragged
dailies	liaised
dairies	diaries
dairy	diary
dairy's	diary's
dales	deals	lades	leads
dallied	dialled
dallies	sallied
dam	mad
damneder	remanded
dampest	stamped
damsel	medals
damson	nomads
dander	darned
dandier	drained
dandle	landed
danger	gander	garden	ranged
danger's	gander's	garden's
dangered	deranged	gardened
dangering	deranging	gardening
dangers	ganders	gardens
dangled	gladden
dapper	rapped
dapperer	prepared
dapple	lapped
dapples	slapped
dares	dears	reads
darkest	starked
darted	traded
darting	trading
dash	shad
dashed	shaded
dashes	shades
dashing	shading
dateline	entailed
dates	sated	stead
daunted	undated
dawdle	waddle
dawdled	waddled
dawdler	drawled
dawdles	swaddle	waddles
dawdling	waddling
dawns	wands
deaden	deaned
deadest	sedated
deadlier	derailed
deaf	fade
deafer	feared
deafest	defeats	feasted
dealer	leader
dealer's	leader's
dealers	leaders
dealership	leadership
dealership's	leadership's
dealings	signaled
dearer	reader	reared	reread
dearest	sedater
dearth	hatred	thread
dearth's	hatred's	thread's
dearths	hardest	hatreds	threads	trashed
death	hated
deaths	hasted
deaves	evades
debase	seabed
debases	seabeds
debut	tubed
decadent	decanted
decadents	descanted
decaf	faced
decal	laced
decals	scaled
decants	descant	scanted
deceiver	received
decide	deiced
decimals	declaims	medicals
decimate	medicate
decimated	medicated
decimates	medicates
decimating	medicating
decimation	medication
decimation's	medication's
declines	licensed	silenced
decree	recede
decreed	receded
decrees	recedes
decries	deicers
deduce	deuced
deduces	seduced
deductions	discounted
deeding	deigned
deep	peed
deeper	peered
deepest	steeped
deeply	yelped
deeps	speed
default	faulted
defend	fended
defer	freed	refed
deferment	fermented
defiant	fainted
defiled	fielded
definer	refined
deflation	defoliant
deflation's	defoliant's
deforest	forested	fostered
deform	formed
deforms	serfdom
defray	frayed
defrost	frosted
defrosters	fortressed
degrading	niggarded
deification	edification
deification's	edification's
deified	edified
deifies	edifies
deify	edify
deifying	edifying
deigns	design	signed	singed
deism	dimes
deletes	sleeted	steeled
deli	idle	lied
deli's	lied's
delight	lighted
delights	slighted
delimit	limited
delis	idles	sidle	slide
deliver	relived	reviled
delivers	silvered	slivered
deltas	lasted	salted	slated	staled
delude	dueled	eluded
deluding	indulged
demanded	maddened
demanding	maddening
demands	maddens
demarcate	macerated
demeanor	enamored
demerit	merited	mitered
demised	misdeed
demo	dome	mode
demo's	dome's	mode's
demos	domes	modes
demote	emoted
demotion	motioned
demount	mounted
demurest	mustered
demurred	murdered
demurrer	murderer
demurring	murdering
denatures	sauntered
denied	indeed
denim	mined
denominate	emendation
denominates	emendations
denotation	detonation
denotation's	detonation's
denotations	detonations
dens	ends	send
denser	resend	sender
densities	destinies
density	destiny
density's	destiny's
dent	tend
dented	tended
dentin	indent	intend	tinned
denting	tending
dentist	stinted
dents	tends
denture	tenured
dentures	unrested
denude	endued
depart	parted	petard	prated
departed	predated
departing	predating
departs	petards
depend	pended
deplane	paneled
deport	ported
deports	sported
deposit	dopiest	posited	topside
deposition	positioned
depositor	droopiest
deposits	topsides
depot	opted
depots	despot	posted
deprave	pervade
depraved	pervaded
depraves	pervades
depraving	pervading
depress	pressed
deprogram	programed
derail	railed	relaid
derailments	streamlined
deranges	grandees	grenades
derides	desired	resided
derives	diverse	revised
dervish	shrived
descent	scented
description	predictions
desert	deters	rested
deserts	dessert
deserve	severed
designer	redesign	resigned
designers	redesigns
desire	eiders	reside
desires	resides
desiring	residing	ringside
despoil	spoiled
desserts	stressed
destine	steined
destining	indigents
detail	dilate	tailed
details	dilates
detains	instead	satined	stained
deter	treed
detest	tested
dethrones	shortened
detour	routed	toured
detours	dourest
deuces	seduce
developer	redevelop
developers	redevelops
deviates	sedative
devil	lived
devise	sieved
devoid	voided
devolve	evolved
devote	vetoed
dewier	weired
dialed	laddie
diameters	dreamiest
diaper	paired	repaid
diatoms	mastoid
dibble	libbed
dice	iced
dickiest	stickied
diddle	lidded
dies	ides	side
dies's	side's
dieted	edited
dieting	editing	ignited
dietitian	initiated
diets	edits	sited	tides
differ	riffed
digger	rigged
dignifies	signified
dignity	tidying
dignity's	tidying's
dikes	skied
dilly	idyll
dilly's	idyll's
dilutes	duelist
dim	mid
dimer	mired	rimed
dimmer	rimmed
dimple	limped
dimples	simpled
dinettes	insetted
dingo	doing
dingo's	doing's
dingy	dying
directer	redirect
directest	trisected
directions	discretion
direr	drier	rider
direst	driest	stride
dirge	ridge
dirge's	ridge's
dirges	ridges
dirtiness	disinters
discerned	rescinded
discerning	rescinding
discerns	rescinds
discover	divorces
discoverer	rediscover
discoverers	rediscovers
discreet	discrete
disease	seaside
disease's	seaside's
diseases	seasides
dishes	hissed
dishing	shindig
dishonest	hedonists
disk	kids	skid
disks	skids
dismalest	medalists
dispel	lisped
disperse	presides
disport	tripods
disprove	provides
dissent	snidest
dissenter	residents	tiredness
dissing	sidings
distaste	staidest
distincter	interdicts
distorter	torridest
disuse	issued
dithers	shirted
ditties	tidiest
divans	viands
diverge	grieved
divers	drives
diverts	strived
dives	vised
dockets	stocked
doers	rodes	sored
does	dose	odes
dogs	gods
doings	dosing
doles	lodes	soled
dolt	told
dons	nods
doodler	drooled
door	odor	rood
door's	odor's	rood's
doors	odors	roods
doorstep	torpedos
dopes	posed
dopier	period
dormant	mordant
dormants	mordants
dos	sod
dote	toed
doubter	obtrude	redoubt
doubter's	redoubt's
doubters	obtrudes	redoubts
dourer	ordure
douses	soused
dovetail	violated
dowel	lowed
dowels	slowed
downers	wonders
download	woodland
downloads	woodlands
dowries	rowdies	weirdos
dowry	rowdy	wordy
dowse	sowed
dozen	zoned
drag	grad
drag's	grad's
dragnet	granted
dragnets	grandest
drags	grads
drainage	gardenia
drainage's	gardenia's
drainer	randier
drains	nadirs
drape	padre	pared	raped
drapes	padres	parsed	rasped	spared	spread
drawer	redraw	reward	warder	warred
drawer's	reward's	warder's
drawers	redraws	rewards	warders
drawing	warding
draws	sward	wards
dray	yard
dray's	yard's
drays	yards
dreamer	rearmed
dreamt	marted
dresser	redress
dried	redid
driers	riders	sirred
dries	rides	sired
drollest	strolled
drolly	lordly
drones	snored
drop	prod
drops	prods
drowsed	sworded
drowsing	swording	wordings
drugged	grudged
drugging	grudging
dueling	eluding	indulge
duels	slued
duffer	ruffed
dummies	mediums
dumpier	umpired
dune	nude
dunes	nudes
dungaree	underage
dunged	nudged
dunging	nudging
dunnest	stunned
duodenal	unloaded
dust	stud
dust's	stud's
duster	rudest	rusted
dusters	trussed
dusts	studs
duties	suited
dwindles	swindled
dykes	skyed
eagerest	steerage
eaglet	legate
eaglet's	legate's
eaglets	legates
earfuls	refusal
earls	laser
earned	endear	neared
earner	nearer
earning	grannie	nearing
earnings	grannies
earns	nears	saner	snare
earthed	hearted
earthier	heartier
earthiest	heartiest
earthiness	heartiness
earthiness's	heartiness's
earthing	hearting
earthliest	stealthier
earthling	haltering	lathering
earthlings	slathering
earthy	hearty
easel	lease
easel's	lease's
easels	leases
eating	teaing
edge	geed
edger	greed
edges	sedge
editions	sedition
editor	rioted
editors	sortied	steroid	storied
eels	else	lees
eglantine	inelegant
egocentric	geocentric
egos	goes
egret	greet
egrets	greets
eighth	height
eighths	heights	highest
ekes	seek
elapsed	pleased
elapses	pleases
elapsing	pleasing
elastic	laciest
elating	gelatin	genital
elation	toenail
elation's	toenail's
elections	selection
electives	selective
electors	selector
elects	select
elegiacs	legacies
elisions	oiliness
elitism	limiest
ells	sell
em	me
emailed	limeade
emanate	enemata	manatee
emanates	manatees
emigrants	mastering	streaming
emirate	meatier
emirates	steamier
emirs	mires	miser	rimes
emit	item	mite	time
emits	items	mites	smite	times
empires	premise
ems	mes
enamors	oarsmen
enclave	valence
enclave's	valence's
enclaves	valences
encoder	encored
ending	ginned
endings	sending
endive	envied	veined
endow	owned
endows	snowed
endues	ensued
endures	ensured
enemas	seamen
enervate	venerate
enervated	venerated
enervates	venerates
enervating	venerating
enervation	veneration
enervation's	veneration's
enfold	fondle
enfolds	fondles
engined	needing
enigma	gamine
enigma's	gamine's
enigmas	gamines	seaming
enlarge	general
enlarges	generals
enlist	inlets	listen	silent	tinsel
enlisted	listened	tinseled
enlisting	listening	tinseling
enlists	listens	silents	tinsels
enrage	genera
enrols	loners
enshroud	unhorsed
ensigns	sensing
enslave	leavens
ensnares	nearness
entails	salient	saltine
enterprises	intersperse
entirety	eternity
entirety's	eternity's
entrails	latrines
entrances	renascent
entrap	parent
enumeration	mountaineer
enumeration's	mountaineer's
enumerations	mountaineers
epics	spice
episode	poesied
epitaphs	happiest
equals	squeal
equip	pique
equips	piques
erased	seared
erasing	regains	searing
erasures	reassure
erections	secretion
erects	secret
erodes	redoes
eroticism	isometric
erratum	maturer
erring	ringer
erupted	reputed
erupting	reputing
erupts	purest
escape	peaces
escapism	scampies
escapist	spaciest
espressos	repossess
espy	yeps
esquire	queries
esters	resets	serest	steers
esthete	teethes
estimate	meatiest
estimated	meditates
estimates	steamiest
estrange	reagents	sergeant
estranges	greatness	sergeants
eta's	tea's
ether	there	three
ether's	there's	three's
ethics	itches
ethos	those
euros	rouse
evener	veneer
evens	seven
ever	veer
everglade	leveraged
evidents	invested
eviler	relive	revile
evilly	lively	vilely
ewe	wee
ewer	weer	were
ewers	sewer
ewes	wees
exacter	excreta
exalt	latex
exalts	laxest
exams	maxes
except	expect
excepted	expected
excepting	expecting
excepts	expects
excitation	intoxicate
exist	exits
exists	sexist
expands	spandex
expediters	preexisted
expos	poxes
fairness	sanserif
faithless	flashiest
faker	freak
faker's	freak's
fakers	freaks
false	fleas	leafs
falser	flares
falsest	festals
fare	fear
fare's	fear's
fares	fears	safer
farmed	framed
farmers	framers
farming	framing
fart	frat	raft
fart's	frat's	raft's
farting	rafting
farts	frats	rafts
fast	fats
fastens	fatness
fate	feat	feta
fate's	feat's	feta's
fauns	snafu
feasts	safest
feeder	reefed
feeding	feigned
feel	flee
feeling	fleeing
feels	flees
feints	finest	infest
feistier	fieriest
feistiest	testifies
fer	ref
feral	flare
ferry	fryer
ferry's	fryer's
fester	freest
fetishist	shiftiest
feuds	fused
fickler	flicker
fidget	gifted
fief	fife
fief's	fife's
fiefs	fifes
fielder	refiled
fiend	fined
fiendish	finished
fifties	iffiest
fighter	freight
fighter's	freight's
fighters	freights
files	flies	liefs
filets	fliest	itself	stifle
filler	refill
fillers	refills
filter	trifle
filter's	trifle's
filters	trifles
filtration	flirtation
filtration's	flirtation's
finagle	leafing
finder	friend
finder's	friend's
finders	friends
finer	infer
finger	fringe
finger's	fringe's
fingers	fringes
finisher	refinish
finked	knifed
finking	knifing
fire	rife
fired	fried
fires	fries
first	rifts
firths	shrift
fissure	fussier
fist	fits	sift
fists	sifts
fitness	infests
flair	frail
flaks	flask
flashback	halfbacks
flatcar	fractal
flatcars	fractals
flea	leaf
flea's	leaf's
flesh	shelf
flesh's	shelf's
flier	lifer	rifle
flier's	lifer's	rifle's
fliers	lifers	rifles
flirted	trifled
flirting	trifling
flit	lift
flits	lifts
flog	golf
flogs	golfs
flooder	floored
flowed	fowled	wolfed
flowing	fowling	wolfing
flows	fowls	wolfs
flue	fuel
flue's	fuel's
flues	fuels
fluster	restful
foaled	loafed
foaling	loafing
foals	loafs
fodder	forded
for	fro
forces	fresco
foresters	reforests
foresting	fostering
forests	fosters
forge	gofer
forge's	gofer's
forges	gofers
form	from
former	reform
forte	ofter
forth	froth
fortieths	frothiest
foundling	unfolding
fount	futon
founts	futons
free	reef
freeing	reefing
freer	refer
frees	reefs
fresher	refresh
freshest	freshets
fretful	truffle
friendlies	infielders
furs	surf
fustier	surfeit
gadget	tagged
gaiter	triage
gaiter's	triage's
gal	lag
gals	lags	slag
gamma	magma
gamma's	magma's
ganged	nagged
ganging	nagging
ganglier	regaling
gaoled	goaled
gaoling	goaling
gaped	paged
gapes	pages
gaping	paging
gapings	gasping
gaps	gasp
gardener	garnered
garners	rangers
garnish	sharing
garret	garter	grater
garret's	garter's	grater's
garrets	garters	graters
gas	sag
gases	sages
gash	hags	shag
gastric	tragics
gateway	getaway
gateway's	getaway's
gateways	getaways
gazer	graze
gazers	grazes
gear	rage
gear's	rage's
gears	rages	sager
gel	leg
gel's	leg's
gelding	niggled
geldings	sledging
gelid	glide
gels	legs
gems	megs
generate	teenager
generates	teenagers
genial	linage
genies	seeing
genitals	stealing
genres	greens
gentiles	sleeting	steeling
gentries	integers	steering
geraniums	measuring
germinal	malinger
gesturing	grungiest
ghouls	slough
giants	sating
gibbons	sobbing
gilded	glided
gilding	gliding
gingko	ginkgo
gingkoes	ginkgoes
gingkos	ginkgos
gins	sign	sing
gird	grid
girded	ridged
girding	griding	ridging
girdle	glider
girdle's	glider's
girdled	griddle
girdles	gliders
girds	grids
girt	grit	trig
girth	right
girths	rights
girts	grist	grits
glinted	tingled
glinting	tingling
glisten	tingles
gloominess	neologisms
gloried	godlier
gloss	slogs
glossed	godless
gluier	uglier
gluiest	ugliest
gnarliest	integrals	triangles
gnash	hangs
gnashing	hangings
gnat	tang
gnat's	tang's
gneiss	singes
gnu	gun
gnu's	gun's
goat	toga
goat's	toga's
goats	togas
goblin	lobing
goiter	goitre
goiters	goitres	goriest
golder	lodger
gores	gorse	ogres
goring	gringo
gory	gyro	orgy
gosh	hogs
got	tog
graders	regards
gradient	treading
grading	niggard
grandee's	grenade's
granite	ingrate	tangier	tearing
granite's	ingrate's
grape	pager
grape's	pager's
grapes	pagers
grates	greats
grayest	gyrates
greedy	greyed
greened	reneged
greening	reneging
greenish	sheering
grenadier	rereading
grin	ring
grinned	rending
grins	rings
grip	prig
grip's	prig's
grips	prigs	sprig
groins	soring
grounded	underdog
grouper	regroup
groupers	regroups
grouse	rogues	rouges
grown	wrong
grudge	rugged
grunts	strung
guests	gusset
guiled	uglied
guiles	uglies
gulp	plug
gulps	plugs
gum	mug
gum's	mug's
gums	mugs	smug
gunshot	noughts	shotgun
gunshot's	shotgun's
gunshots	shotguns
gurgles	slugger
gush	hugs
gust	guts	tugs
gustier	gutsier
gustiest	gutsiest
gusty	gutsy
gut	tug
gyrated	tragedy
gyrations	signatory
gyro's	orgy's
hackles	shackle
hacks	shack
hafts	shaft
hahs	hash	shah
hairbreadths	hairsbreadth
hakes	shake
hallows	shallow
halls	shall
halos	shoal
halt	lath
halt's	lath's
halted	lathed
halter	lather
halter's	lather's
haltered	lathered
halters	lathers	slather
halting	lathing
halts	laths	shalt
hams	mash	sham
handfuls	handsful
handouts	thousand
hangover	overhang
hangovers	overhangs
hanker	harken
hankered	harkened
hankering	harkening
hankers	harkens
hardier	harried
hared	heard
harems	masher
hares	hears	rheas	share	shear
harks	shark
harshest	thrashes
harts	trash
hash's	shah's
hasn't	shan't
hassle	lashes
hassled	slashed
hassles	slashes
hassling	slashing
haste	hates	heats
hatchets	thatches
hats	shat
hatter	threat
hatter's	threat's
hatters	shatter	threats
haul	hula
hauled	hulaed
hauling	hulaing
havens	shaven
haves	shave
hawser	washer
hawser's	washer's
hawsers	washers
hayed	heady
heaps	phase	shape
hearers	shearer
hearings	hearsing	shearing
heater	reheat
heaths	sheath
heaves	sheave
hectors	torches
heeding	neighed
heir	hire
heisting	nighties
heists	thesis
helot	hotel
hems	mesh
hepatics	pastiche
heptagon	pathogen
heptagon's	pathogen's
heptagons	pathogens
herds	shred
herein	inhere
heroins	inshore
heros	horse	shore
herpes	sphere
herpes's	sphere's
hes	she
hewer	where
hewers	wheres
hewn	when
hide	hied
hides	shied
hikers	shriek	shrike
hikes	sheik
hills	shill
hims	shim
hinge	neigh
hinge's	neigh's
hinges	neighs
hint	thin
hints	thins
hips	ship
hits	shit	this
hitting	tithing
hocks	shock
hods	shod
hoes	hose	shoe
holdup	uphold
holdups	upholds
holiest	hostile
holster	hostler
holster's	hostler's
holsters	hostlers
homeowners	horsewomen
hones	shone
hooks	shook
hooped	poohed
hooping	poohing
hoops	poohs
hoots	shoot	sooth
hoppers	shopper
hops	posh	shop
hornets	shorten	thrones
horns	shorn
horse's	shore's
horseman	menorahs
horses	shores
horsing	shoring
hos	ohs
hose's	shoe's
hosed	shoed
hoses	shoes
host	shot
host's	shot's
hosts	shots
hot	tho
housewares	warehouses
housework	workhouse
housework's	workhouse's
hovels	shovel
hovers	shrove
how	who
however	whoever
hows	show
howsoever	whosoever
hug	ugh
huhs	hush
humidor	rhodium
humidor's	rhodium's
hums	mush
hungover	overhung
hunts	shunt
huntsman	manhunts
hurdle	hurled
hurricane	raunchier
hurtles	hustler
hustle	sleuth
hustlers	ruthless
hustles	lushest	sleuths
hustling	sunlight
huts	shut	thus	tush
icecap	ipecac
icecap's	ipecac's
icecaps	ipecacs
iciness	incises
idler	riled
idlers	slider
idlest	listed	silted	stiled	tildes
idly	idyl
idolater	tailored
idols	solid
ignite	tieing
ignore	region
ignores	regions
ilks	silk
ills	sill
imam	maim
imams	maims
immersed	simmered
immersing	simmering
impeding	impinged
impels	simple
imperatives	semiprivate
imperfections	perfectionism
impersonated	predominates
impetus	imputes
imports	tropism
importunate	permutation
importunates	permutations
importunes	resumption
impregnate	permeating
impress	premiss	simpers
impression	permission
impression's	permission's
impressions	permissions
impressive	permissive
impressively	permissively
impressiveness	permissiveness
impressiveness's	permissiveness's
imprints	misprint
impugn	umping
impugns	spuming
impure	umpire
impurest	stumpier
inapt	paint
incenses	niceness
inceptions	inspection
incessant	instances
incest	insect	nicest
incest's	insect's
inches	niches
incised	indices
incorporate	procreation
indefinites	intensified
indented	intended
indenting	intending
indents	intends
index	nixed
indiscreet	iridescent
indorse	rosined
inert	inter	niter
inerts	insert	inters
infarction	infraction
infarction's	infraction's
infidel	infield
infidel's	infield's
infidels	infields
infringe	refining
ingest	signet	tinges
ingests	signets
ingrain	raining
ingress	resigns	signers	singers
ink	kin
ink's	kin's
inkling	kilning	linking
inks	kins	sink	skin
inners	sinner
innings	sinning
inroads	ordains
ins	sin
insecure	sinecure
insets	steins
insisted	tidiness
insole	lesion
insole's	lesion's
insoles	lesions	lioness
inspire	spinier
instep	spinet
instep's	spinet's
insteps	spinets
instrument	nutriments
insular	urinals
insult	sunlit
insulted	unlisted
insure	inures
insureds	sundries
insures	sunrise
insurgent	unresting
intagli	tailing
intaglios	isolating
integer	treeing
integration	orientating
interests	triteness
interim	mintier	termini
interpreter	reinterpret
interpreters	reinterprets
interred	trendier
intervened	reinvented
intervening	reinventing
intones	tension
introduce	reduction
introduces	reductions
intrude	untried
inure	urine
inured	ruined
inuring	ruining
invader	ravined
inverts	striven
irately	reality
irksome	smokier
ironies	noisier
irons	rosin
isle	leis	lies
islet	lites	stile	tiles
islet's	stile's
islets	sliest	stiles
isn't	nit's	tin's
itchiest	theistic
item's	mite's	time's
iterates	teariest	treaties	treatise
its	sit
jaunt	junta
jaunt's	junta's
jaunts	juntas
jest	jets
joiner	rejoin
joiners	rejoins
jounces	juncoes
just	juts
kale	lake	leak
kale's	lake's	leak's
keels	leeks	sleek
keen	knee
keening	kneeing
keens	knees
keep	peek
keeping	peeking
keeps	peeks
keynotes	keystone
kills	skill
kiln	link
kiln's	link's
kilned	kindle	linked
kilns	links	slink
kinder	rinked
kindles	slinked
kingpin	pinking
kinship	pinkish
kippers	skipper
kiss	skis
kisser	skiers
kitchen	thicken
kitchened	thickened
kitchening	thickening
kitchens	thickens
kite	tike
kite's	tike's
kites	tikes
kits	skit
kitsch	shtick
knead	naked
kneader	nakeder
kneads	snaked
knits	stink
knitter	trinket
knitter's	trinket's
knitters	trinkets
laces	scale
lactose	locates
ladder	larded
lair	liar	lira	rail
lair's	liar's	lira's	rail's
lairs	liars	liras	rails
lakes	leaks	slake
lambkins	lambskin
lamed	medal
lameness	maleness	nameless	salesmen
lameness's	maleness's
laments	mantels	mantles
lamer	realm
lamest	metals
laming	malign
lamp	palm
lamp's	palm's
lamps	palms	psalm
lanes	leans
languid	lauding
lanker	rankle
lap	pal
lap's	pal's
lapse	leaps	pales	peals	pleas	sepal
lapse's	sepal's
lapsed	pedals	pleads
lapses	passel	sepals
lapsing	palings	sapling
last	lats	salt	slat
lasting	salting	slating	staling
lasts	salts	slats
latent	talent
latents	talents
latter	rattle
lattice	tactile
laxer	relax
layered	relayed
layering	relaying	yearling
layers	relays	slayer
layout	outlay
layout's	outlay's
layouts	outlays
layover	overlay
layovers	overlays
lays	slay
laze	zeal
leaden	leaned
leaking	linkage
leap	pale	peal	plea
leaped	pealed
leaping	pealing
learn	renal
learner	relearn
learners	relearns
leased	sealed
leash's	shale's
leasing	sealing
leaved	vealed
leaving	vealing
ledges	sledge
leer	reel
leered	reeled
leeriest	sleetier	steelier
leering	reeling
leers	reels
lefties	liefest
legions	lingoes
legman	mangle
lemon	melon
lemon's	melon's
lemons	melons	solemn
lenders	slender
lenients	sentinel
lenses	lessen
lentil	lintel
lentil's	lintel's
lentils	lintels
leopard	paroled
leotards	lodestar
leper	repel
lepers	repels
lept	pelt
lessened	needless
lessor	losers
lest	lets	tels
letters	settler	trestle
levees	sleeve
lever	revel
levered	reveled
levering	reveling
levers	revels
levied	veiled
lewd	weld
lewder	welder
license	silence
license's	silence's
licenses	silences
licensing	silencing
lickings	sickling	slicking
licks	slick
lids	slid
liefer	refile	relief
liens	lines
lighters	slighter
lights	slight
likens	silken
lilt	till
lilted	tilled
lilting	tilling
lilts	still	tills
limestone	milestone
limestone's	milestone's
limpest	limpets
lineman	melanin
lineman's	melanin's
lineup	lupine
lineups	lupines
lingos	losing	soling
lionesses	noiseless
lions	loins
lipreads	spiraled
lips	lisp	slip
lisping	pilings
lisps	slips
list	silt	slit
list's	silt's
listener	reenlist	silenter
listeners	reenlists
listing	silting	stiling
lists	silts	slits
lite	tile
literates	statelier
lithest	thistle
litters	slitter
littoral	tortilla
littorals	tortillas
livens	snivel
liver	viler
livers	silver	sliver
livery	verily
livest	vilest
loaders	ordeals	reloads
lobs	slob
loftier	trefoil
loges	ogles
logs	slog
loiter	toiler
loiters	toilers
longitudes	ungodliest
lookout	outlook
lookout's	outlook's
lookouts	outlooks
looped	poodle	pooled
looping	pooling
loops	pools	sloop	spool
loosed	oodles	soloed
loosing	soloing
loot	tool
loot's	tool's
looter	retool
looters	retools
looting	tooling
loots	stool	tools
lop	pol
loped	poled
loping	poling
lops	pols	slop
lore	role
lore's	role's
loser	roles
loses	sloes	soles
loss	sols
lost	lots	slot
lotus	louts
lotuses	tousles
loudest	tousled
louvers	velours
loved	voled
lovely	volley
lover	velor
lovers	solver
loves	solve	voles
loving	voling
lovings	solving
low	owl
lower	rowel
lowered	roweled
lowering	roweling
lowers	rowels	slower
lowest	owlets	towels
lowish	owlish
lows	owls	slow
luaus	usual
lubber's	rubble's
lucre's	ulcer's
lugs	slug
lumber	rumble
lumbers	rumbles	slumber
lump	plum
lump's	plum's
lumped	plumed
lumping	pluming
lumps	plums	slump
lungs	slung
lure	rule
lured	ruled
lures	rules
luring	ruling
lust	slut
lust's	slut's
lusts	sluts
lyre	rely
lyres	slyer
macho	mocha
magenta	magnate
magenta's	magnate's
magneto	megaton	montage
magneto's	megaton's	montage's
magnetos	megatons	montages
maidens	medians
mailers	realism
makings	masking
mane's	name's
mangier	reaming
mangiest	steaming
manlier	mineral
mantes	stamen
mantis	matins
mantis's	matins's
manured	maunder	unarmed
manures	surname
many	myna
maples	sample
mapper	pamper
maracas	mascara
marbled	rambled
marbles	rambles
marbling	rambling
mares	reams	smear
markers	remarks
marshes	mashers
mart	tram
mart's	tram's
martens	smarten
marting	migrant
marts	smart	trams
mash's	sham's
mashed	shamed
mashes	shames
mashing	shaming
mast	mats	tams
master	stream	tamers
master's	stream's
mastered	streamed
mat	tam
mat's	tam's
mate	meat	tame	team
mate's	meat's	team's
mated	tamed
mates	meats	steam	tames	teams
mating	taming
matrons	transom
mattes	tamest
mattress	smartest
maws	swam
mayor	moray
mayor's	moray's
mayors	morays
meander	renamed
meaner	rename
mechanics	mischance
medalist	misdealt
meddle	melded
meet	mete	teem
meeting	teeming
meets	metes	teems
melding	mingled
melts	smelt
menials	seminal
mentors	monster
merest	meters
merit	miter	remit	timer
merit's	miter's	timer's
meriting	mitering
mesa's	seam's
mesas	sames	seams
meteor	remote
meteors	remotes
metering	regiment
midterm	trimmed
mien	mine
miens	mines
migrants	smarting
mildness	mindless
mils	slim
minaret	raiment
minaret's	raiment's
minuet	minute
minuet's	minute's
minuets	minutes
minutely	untimely
miracle	reclaim
miracles	reclaims
miring	riming
misdeal	mislead
misdealing	misleading
misdeals	misleads
misers	remiss
misfortune	uniformest
misled	smiled
misreads	sidearms
missile	similes
misspelt	simplest
mist	smit
misting	smiting	timings
mittens	smitten
mocks	smock
models	seldom
modern	morned	normed
modernizes	sermonized
moist	omits
moister	mortise
molar	moral
molars	morals
molders	smolder
molest	motels
monotones	moonstone
moodiest	sodomite
moored	roomed
mooring	rooming
mope	poem
moraine	romaine
moraine's	romaine's
morn	norm
morn's	norm's
morning	norming
morns	norms
most	toms
mote	tome
mote's	tome's
motes	smote	tomes
motleyer	remotely
mouses	mousse
mu	um
muggers	smugger
muggings	smugging
mundane	unnamed
musings	mussing
muss	sums
mussier	surmise
mutilate	ultimate
mutilated	ultimated
mutilates	stimulate	ultimates
mutilating	ultimating
mutilations	stimulation
mutual	umlaut
nails	slain	snail
naiver	ravine	vainer
naives	navies
naivest	natives	vainest
naps	pans	snap	span
nark	rank
nark's	rank's
narking	ranking
narks	ranks
nastier	retains	retinas
nastily	saintly
nasty	tansy
nattier	nitrate
natures	saunter
navel	venal
nebula	unable
nectarines	transience
neither	therein
neon	none
nepotism	pimentos
nerd	rend
nerds	rends
nerviest	reinvest
nest	nets	sent	tens
nested	tensed
nesting	tensing
net	ten
net's	ten's
netted	tented
netting	tenting
neurons	nonuser
neurosis	resinous
neuter	tenure	tureen
neuters	tenures	tureens
new	wen
newer	renew
news	sewn	wens
newsier	wieners
newt	went
niggers	snigger
night	thing
night's	thing's
nightcap	patching
nights	things
nip	pin
nips	pins	snip	spin
nit	tin
nitpicks	stickpin
nitrates	straiten
nits	snit	tins
no	on
nodes	nosed
noises	nosies
nope	open	peon	pone
nopes	opens	peons	pones
not	ton
noted	toned
notices	section
noting	toning
nous	onus
nous's	onus's
novels	sloven
now	own	won
nowhere	whereon
nuclear	unclear
nuder	under	urned
nudity	untidy
nurse	runes
nursed	sunder
nurture	untruer
nut	tun
nuts	stun	tuns
oafs	sofa
oaks	soak
observe	obverse	verbose
observes	obverses
odder	roded
oiled	oldie
onrushes	unhorses
onrushing	unhorsing
onsets	stones
opener	reopen
openers	reopens
opines	ponies
opt	pot	top
optic	topic
optically	topically
optics	topics
option	potion
option's	potion's
options	potions
opus	soup
opus's	soup's
opuses	spouse
orals	solar
orbs	robs
ore	roe
ore's	roe's
organist	roasting
other	throe
others	throes
otter	torte
otter's	torte's
otters	tortes
ought	tough
ours	sour
oust	outs
ouster	outers	routes
ousters	sourest
ousting	outings
outer	route
outsell	sellout
outsells	sellouts
outside	tedious
outtake	takeout
outtakes	stakeout	takeouts
ovals	salvo
over	rove
overacts	overcast
overate	overeat
overdoes	overdose
overs	roves	servo
overt	voter
overtake	takeover
overtakes	takeovers
overturn	turnover
overturns	turnovers
owe	woe
owes	woes
owlet	towel
owlet's	towel's
owners	worsen
oysters	storeys
pailfuls	pailsful
painless	spaniels
painter	pertain	repaint
painters	pantries	pertains	repaints
paled	pedal	plead
palest	pastel	petals	plates	pleats	staple
palmists	psalmist
palsy	plays	splay
palsying	splaying
paltry	partly
panelist	plainest
panted	pedant
pantie	patine
panties	sapient
papery	prepay
parceled	replaced
parceling	replacing
parental	paternal	prenatal
pares	parse	pears	rapes	reaps	spare	spear
paring	raping
parings	parsing	rasping	sparing
parley	pearly	player	replay
parley's	player's	replay's
parleyed	replayed
parleying	replaying
parleys	parsley	players	replays	sparely
parried	rapider
parries	rapiers	raspier	repairs
parroted	predator	prorated	teardrop
parroting	prorating
pars	raps	rasp	spar
parsecs	scrapes
parser	sparer
part	rapt	tarp	trap
part's	tarp's	trap's
partied	pirated
parties	pastier	pirates	traipse
parting	prating
partitioned	trepidation
parts	sprat	strap	tarps	traps
passed	spades
past	pats	spat	taps
paste	pates	septa	spate	tapes
paste's	spate's
pastel's	staple's
pastes	spates
pasties	patsies
pastries	raspiest	traipses
pasts	spats
pathos	potash
pathos's	potash's
paths	staph
patios	patois
patricide	pediatric
patricides	pediatrics
patrol	portal
patrol's	portal's
patrols	portals
patron	tarpon
patron's	tarpon's
patrons	tarpons
patterns	transept
patters	spatter
pawns	spawn
pay	yap
payers	repays
pays	spay	yaps
peaks	spake	speak
peal's	plea's
pearled	pleader
pecks	speck
pedaled	pleaded
pedaling	pleading
pederast	predates	repasted
peels	sleep
peerless	sleepers
peers	spree
pees	seep
pelts	slept	spelt
pends	spend
penetrations	presentation
penis	pines	snipe	spine
penis's	snipe's	spine's
pents	spent
peon's	pone's
peppier	preppie
percale	replace
percales	replaces
percussion	supersonic
perfect	prefect
perfects	prefects
periled	replied
perils	pliers
peripatetic	precipitate
peripatetics	precipitates
perms	sperm
persist	priests	spriest	sprites	stripes
persistent	prettiness
persisting	springiest
pertained	repainted
pertaining	repainting
pertness	presents	serpents
perts	strep
peruse	purees	rupees
perused	supered
perusing	supering
perverse	preserve
peso	pose
pesos	poses	posse
pesters	presets
pests	steps
petites	petties
petitioner	repetition
petitioner's	repetition's
petitioners	repetitions
petitions	pointiest
petrels	respelt
pews	spew
phase's	shape's
phased	shaped
phases	shapes
phasing	shaping
phrasing	sharping
pickets	skeptic
pieces	specie
pier	ripe
pierces	precise	recipes
piers	pries	ripes	spire
pigment	temping
pigskin	spiking
pikes	spike
piled	plied
piles	plies	spiel
pillages	spillage
pills	spill
pilots	pistol	spoilt
pincers	princes
pinto	piton	point
pintos	piston	pitons	points
pis	sip
piss	sips
pisses	sepsis
pit	tip
piton's	point's
pits	spit	tips
plainer	praline
plains	spinal
plaint	pliant
planet	platen
planet's	platen's
planets	platens
platitudes	stipulated
platter	prattle
platters	prattles	splatter
pleaders	relapsed
pluses	pulses
pointer	protein
pointer's	protein's
pointers	proteins
poises	posies
poisoner	snoopier
pokes	spoke
polyester	proselyte
polyester's	proselyte's
polyesters	proselytes
polyps	sloppy
polythene	telephony
polythene's	telephony's
ponders	respond
poodles	spooled
pore	rope
pores	poser	prose	ropes	spore
poring	roping
portered	reported
portering	reporting
porters	reports
portions	positron
portrayed	predatory
ports	sport	strop
poser's	prose's	spore's
posers	proses	spores
positional	spoliation
poster	presto	tropes
posters	prestos
postman	tampons
posts	spots	stops
postured	proudest	sprouted
posturing	sprouting
pot's	top's
potters	protest	spotter
potties	tiptoes
pouts	spout
pram	ramp
pram's	ramp's
prates	repast	tapers
prayers	sprayer
prays	raspy	spray
precisest	tricepses
precursor	procurers
predator's	teardrop's
predators	teardrops
predecessor	reprocessed
predicts	scripted
preludes	repulsed
premised	simpered
premising	simpering
present	repents	serpent
presented	serpented
presenter	represent
presenting	serpenting
preses	sprees
presume	supreme
preterit	prettier
prey	pyre
prey's	pyre's
pride	pried	riped
prides	spider
prier	riper
primes	simper
printer	reprint
printer's	reprint's
printers	reprints	sprinter
printings	sprinting
procedure	reproduce
procedures	reproduces
procured	producer
prom	romp
proms	romps
pronto	proton
prosiest	ripostes
protest's	spotter's
protests	spotters
prude	pured
prudes	pursed
prys	spry
pseudo	souped
publisher	republish
puers	purse	super
punier	unripe
punks	spunk
puns	spun
punster	punters
puree	rupee
puree's	rupee's
purls	slurp
purples	suppler
purses	supers
pursued	usurped
pursuer	usurper
pursuer's	usurper's
pursuers	usurpers
pursuing	usurping
pus	sup	ups
puss	sups
putters	sputter
quads	squad
quakes	squeak
quartets	squatter
quids	squid
quiet	quite
quieter	requite
quiets	quites
quires	squire
quote	toque
quotes	toques
raggedest	staggered
ragweed	wagered
randiest	strained
rankest	tankers
rapidest	traipsed
rapier	repair
rapist	tapirs
rare	rear
rascal	scalar
rascal's	scalar's
rascals	scalars
rashes	shares	shears
rashest	trashes
rasp's	spar's
rasps	spars
rate	tare	tear
rate's	tare's	tear's
rated	tared	trade	tread
rating	taring
ratings	staring
rationales	senatorial
rationalize	realization
rattan	tartan
rattan's	tartan's
rattans	tartans
ratted	tarted
ratting	tarting
rattles	starlet	startle
rattlings	startling
ravages	savager
ravels	salver	slaver
raw	war
readers	rereads
readiest	steadier
realest	relates
realist	retails	saltier
realizes	sleazier
reamed	remade
rebus	rubes
receivables	serviceable
reclines	silencer
recourse	resource
recourse's	resource's
redcaps	scraped
redness	senders
redound	rounded
redrawing	rewarding	wardering
reduces	rescued	secured	seducer
reeved	veered
reeving	veering
refiles	reliefs
refits	rifest	sifter	strife
refs	serf
refunded	underfed
registrant	restarting
reins	resin	rinse	risen	siren
reinstated	straitened
reinstating	straitening
reissued	residues
relapse	repeals
relatives	versatile
relics	slicer
relives	reviles	servile
reliving	reviling
remades	smeared
rent	tern
rent's	tern's
rented	tender	terned
renters	sterner
renting	terning
repartee	repeater
repartee's	repeater's
repartees	repeaters
repasts	sparest
repertoires	repertories
reposing	spongier
reprise	respire
reprises	respires
reprising	respiring	springier
resale	sealer
resale's	sealer's
resales	sealers
rescue	secure
rescuer	securer
rescues	secures
rescuing	securing
research	searcher
research's	searcher's
resell	seller
reserve	reveres	reverse	severer
reserved	reversed
reserves	reverses
reserving	reversing
resin's	siren's
resins	rinses	sirens
resistant	straitens
resisted	sistered
resisting	sistering
resistor	roisters	sorriest
resold	solder
resorted	restored	rostered
resorting	restoring	rostering
resorts	rosters	sorters
resound	sounder
respect	scepter	specter
respect's	scepter's	specter's
respects	scepters	specters
respell	speller
respells	spellers
restart	starter
restarts	starters
resting	stinger
restive	veriest
restock	rockets
restrain	retrains	strainer	terrains	trainers
restrains	strainers
rests	tress
results	rustles
retain	retina
retard	tarred	trader
retards	starred	traders
retelling	tellering
retells	tellers
rethink	thinker
rethinks	thinkers
retinae	trainee
retinue	reunite	uterine
retinues	reunites
retired	retried	tireder
retires	retries
retrain	terrain	trainer
retrial	trailer
retrial's	trailer's
retrials	trailers
returns	turners
reupholster	upholsterer
reupholsters	upholsterers
reveals	several
review	viewer
reviews	viewers
rewarded	wardered
rewired	weirder
rework	worker
reworks	workers
rewound	wounder
rickets	sticker	tickers
rickets's	sticker's
ridden	rinded
riles	slier
riot	trio
riot's	trio's
rioters	roister
riots	torsi	trios
ripens	sniper
ripost	tripos
ripples	slipper
rises	sires
rising	siring
rites	tiers	tires	tries
rival	viral
rivaling	virginal
rivets	strive
rockiest	stockier
rodents	snorted
rogue	rouge
rogue's	rouge's
roost	roots	torso
roost's	torso's
roosts	torsos
roses	sores
rosiest	sorties	stories
roster's	sorter's
rot	tor
rote	tore
rotes	store
rots	sort	tors
roundest	tonsured
roused	soured
rouses	serous
rousing	souring
rout	tour
rout's	tour's
routing	touring
routs	torus	tours
rowdier	wordier	worried
rowdiest	wordiest
rowdiness	wordiness
rowdiness's	wordiness's
royalist	solitary
rude	rued
rues	ruse	sure	user
ruination	urination
ruination's	urination's
run	urn
runs	urns
runt	turn
runts	turns
runway	unwary
ruse's	user's
ruses	suers	users
rushes	ushers
russet	surest
russets	trusses
rust	ruts
rustiest	trusties
rustled	strudel
rusts	truss
sabers	sabres
sachem	schema
sachem's	schema's
sadden	sanded
sagest	stages
saint's	satin's
saints	satins	stains
sales	seals
salients	saltines
salivated	validates
sallying	signally
salt's	slat's
saltest	stalest
saltiness	stainless
saltpeter	saltpetre
salve	slave	vales	veals
salve's	slave's
salved	slaved
salver's	slaver's
salvers	slavers
salves	slaves
salving	slaving
sandier	sardine
sangs	snags
sanity	satiny
satining	staining
satyrs	strays
sauciest	suitcase
saves	vases
saviour	various
saw	was
sawn	swan
scions	sonics
seabirds	sidebars
seamiest	steamies
seated	sedate	teased
seating	tangies	teasing
seduction	suctioned
seers	seres
seething	sheeting
selves	vessel
selves's	vessel's
senator's	treason's
sensor	snores
sensual	unseals
serened	sneered
serening	sneering
servant	taverns
serve	sever	veers	verse
served	versed
serves	severs	verses
serving	versing
settable	testable
setter	street	tester
setter's	street's	tester's
setters	streets	tersest	testers
setting	testing
settler's	trestle's
settlers	trestles
setup	upset
setups	upsets
shams	smash
shattering	straighten
sheet	thees	these
sheets	theses
shiner	shrine
shiner's	shrine's
shiners	shrines
shipmates	steamship
shittier	thirties
shiver	shrive
shivers	shrives
shooting	soothing
shootings	soothings
shoots	sooths
shower	whores
shriek's	shrike's
shrieks	shrikes
sickled	slicked
sideways	waysides
sidled	slided
sidles	slides
sidling	sliding
sifter's	strife's
signing	singing
signs	sings
silver's	sliver's
silvering	slivering
silvers	slivers
sinew	swine	wines
sinew's	swine's
sinews	swines
singling	slinging
sinks	skins
sitar's	stair's
sitars	stairs
site	ties
sites	sties
sitter	trites
skated	staked	tasked
skater	streak	takers
skater's	streak's
skaters	streaks
skates	stakes	steaks
skating	staking	takings	tasking
skirting	striking
slander	snarled
slangiest	tasseling
slates	stales	steals	tassel
sleet	steel
sleet's	steel's
sleetiest	steeliest
sleets	steels
sleety	steely
slitted	stilted
sloop's	spool's
sloops	spools
slyest	styles
smartened	tradesmen
snakes	sneaks
snaps	spans
snatched	stanched
snatching	stanching
snipes	spines
snips	spins
snoop	spoon
snooped	spooned
snooping	spooning
snoops	spoons
snot	tons
soapstone	teaspoons
solitaires	solitaries
somber	sombre
sonnet	tenons	tonnes
sorbets	strobes
sorest	stores	torses
sorting	storing
sots	toss
sought	toughs
sounding	undoings
sower	swore	worse
sparsest	trespass
spat's	taps's
spawning	wingspan
spilt	split
spindled	splendid
spoonfuls	spoonsful
sport's	strop's
sports	strops
spotlight	stoplight
spotlight's	stoplight's
spotlights	stoplights
spouts	tossup
sprat's	strap's
sprats	straps
sprouts	stupors
stack	tacks
stag	tags
stalk	talks
stalker	talkers
stamp	tamps
stank	tanks
stared	trades	treads
starlets	startles
stars	tsars
start	tarts
state	taste	teats
state's	taste's
stated	tasted
stateless	tasteless
statement	testament
statement's	testament's
statements	testaments
stater	taster	treats
states	tastes
stateside	steadiest
stating	tasting
statute	tautest
staunched	unscathed
stayed	steady
sterned	tenders
steward	strawed
stewed	tweeds	wested
stewing	twinges	westing
stick	ticks
stickler	trickles
stiff	tiffs
stiller	tillers	trellis
stilt	tilts
sting	tings
stingray	straying
stingy	stying
stint	tints
stipple	tipples
stoat	toast
stoat's	toast's
stoats	toasts
stoke	tokes
stoker	stroke
stoker's	stroke's
stokers	strokes
stopping	toppings
story	troys	tyros
stove	votes
stow	tows	twos	wost
strain	trains
straited	striated	tardiest
strapping	trappings
straw	warts
strew	wrest
strewed	wrested
strewing	wresting
strews	wrests
strident	tridents
strike	trikes
stringy	tryings
strip	trips
striptease	tapestries
stroll	trolls
strove	voters
struck	trucks
strumpet	trumpets
strut	trust
struts	trusts
stuck	tucks
student	stunted
stumble	tumbles
stumbler	tumblers	tumbrels
stye	yest
sues	uses
suites	tissue
sump	umps
sunblock	unblocks
sunburned	unburdens
sundering	undersign
sunders	undress
sunspot	unstops
supper	uppers
surge	urges
suture	uterus
suture's	uterus's
swag	wags
swallow	wallows
swarm	warms
swarthiest	sweatshirt
swath	thaws	whats
sway	ways	yaws
swear	wares	wears
swearer	wearers
sweat	waste
sweatier	weariest
sweats	wastes
sweep	weeps
sweeper	weepers
sweeping	weepings
swelter	welters	wrestle
swelters	wrestles
swig	wigs
swill	wills
swindles	wildness
swing	wings
swinger	wingers
swipe	wipes
swisher	wishers
sword	words
tablespoonfuls	tablespoonsful
taints	titans
tannest	tenants
tardier	tarried
tartest	tatters
teaspoonfuls	teaspoonsful
teens	tense
tenon	tonne
tenor	toner
tenor's	toner's
tenure's	tureen's
terrain's	trainer's
terrapins	transpire
thaw	what
theater	theatre
theaters	theatres
theist	tithes
thickest	thickets	thickset
throw	worth	wroth
thrust	truths
tilde	tiled
tilted	titled
timber	timbre
timber's	timbre's
timbers	timbres
tired	tried
titters	tritest
toady	today
toady's	today's
tocsin	tonics
torpedo	trooped
torpid	tripod
tort	trot
torts	trots
tost	tots
tow	two	wot
tower	wrote
town	wont
town's	wont's
trail	trial
trails	trials
travel	varlet
travels	varlets
tribune	turbine
tribune's	turbine's
tribunes	turbines
trout	tutor
trout's	tutor's
trouts	tutors
truest	utters
tumbler	tumbrel
tumbler's	tumbrel's
tuners	unrest
tunes	unset
twist	twits
unaltered	unrelated
underflow	wonderful
undersigns	undressing
unite	untie
united	untied
unites	unties
unreadiest	unsteadier
untiles	utensil
vast	vats
vein	vine
vein's	vine's
vest	vets
veto	vote
veto's	vote's
view	wive
views	wives
vowels	wolves
waist	waits
waiters	wariest
waiver	wavier
wale	weal
wale's	weal's
wandered	wardened
wandering	wardening
wanes	weans
warp	wrap
warps	wraps
way	yaw
weather	whereat	wreathe
weathers	wreathes
weir	wire
weir's	wire's
weird	wider	wired	wried
weirs	wires	wiser	wries
wenches	whences
whale	wheal
whale's	wheal's
whales	wheals
wheedle	wheeled
whist	whits	withs
whit	with
whited	withed
whiter	wither	writhe
whiting	withing
wiggler	wriggle
wigglers	wriggles
wist	wits
withers	writhes
woodworm	wormwood
woodworm's	wormwood's
wriest	writes
wrist	writs
